county,state,labor,employed,unemployed,percent
Autauga,AL,25909,24908,1001,3.9
Baldwin,AL,91567,87915,3652,4
Barbour,AL,8236,7750,486,5.9
Bibb,AL,8506,8133,373,4.4
Blount,AL,24494,23509,985,4
Bullock,AL,4812,4575,237,4.9
Butler,AL,8946,8455,491,5.5
Calhoun,AL,45582,43333,2249,4.9
Chambers,AL,15176,14557,619,4.1
Cherokee,AL,11174,10721,453,4.1
Chilton,AL,19118,18344,774,4
Choctaw,AL,4336,4059,277,6.4
Clarke,AL,7720,7065,655,8.5
Clay,AL,5721,5471,250,4.4
Cleburne,AL,5742,5486,256,4.5
Coffee,AL,20671,19764,907,4.4
Colbert,AL,23092,21889,1203,5.2
Conecuh,AL,4446,4173,273,6.1
Coosa,AL,4348,4147,201,4.6
Covington,AL,15646,14826,820,5.2
Crenshaw,AL,6417,6130,287,4.5
Cullman,AL,37637,36239,1398,3.7
Dale,AL,19868,18987,881,4.4
Dallas,AL,14935,13811,1124,7.5
DeKalb,AL,29038,27734,1304,4.5
Elmore,AL,37236,35880,1356,3.6
Escambia,AL,14352,13630,722,5
Etowah,AL,42894,40932,1962,4.6
Fayette,AL,6529,6220,309,4.7
Franklin,AL,13960,13369,591,4.2
Geneva,AL,10817,10355,462,4.3
Greene,AL,2833,2616,217,7.7
Hale,AL,6007,5653,354,5.9
Henry,AL,6697,6371,326,4.9
Houston,AL,44411,42484,1927,4.3
Jackson,AL,23066,21966,1100,4.8
Jefferson,AL,309076,295970,13106,4.2
Lamar,AL,5703,5462,241,4.2
Lauderdale,AL,41868,39937,1931,4.6
Lawrence,AL,13640,12974,666,4.9
Lee,AL,73520,70643,2877,3.9
Limestone,AL,41092,39457,1635,4
Lowndes,AL,3750,3450,300,8
Macon,AL,7892,7436,456,5.8
Madison,AL,175153,168412,6741,3.8
Marengo,AL,7623,7192,431,5.7
Marion,AL,12517,11918,599,4.8
Marshall,AL,42108,40506,1602,3.8
Mobile,AL,186239,176587,9652,5.2
Monroe,AL,7165,6682,483,6.7
Montgomery,AL,105505,100964,4541,4.3
Morgan,AL,54840,52588,2252,4.1
Perry,AL,3402,3132,270,7.9
Pickens,AL,7783,7371,412,5.3
Pike,AL,15238,14495,743,4.9
Randolph,AL,9373,8961,412,4.4
Russell,AL,23457,22449,1008,4.3
St. Clair,AL,38946,37400,1546,4
Shelby,AL,109331,105804,3527,3.2
Sumter,AL,5016,4688,328,6.5
Talladega,AL,34501,32789,1712,5
Tallapoosa,AL,18279,17519,760,4.2
Tuscaloosa,AL,99237,95127,4110,4.1
Walker,AL,25145,23883,1262,5
Washington,AL,6656,6201,455,6.8
Wilcox,AL,2808,2488,320,11.4
Winston,AL,9646,9164,482,5
Aleutians East,AK,2584,2519,65,2.5
Aleutians West,AK,3861,3721,140,3.6
Anchorage,AK,155462,146175,9287,6
Bethel,AK,7445,6418,1027,13.8
Bristol Bay,AK,426,399,27,6.3
Denali,AK,1130,1024,106,9.4
Dillingham,AK,2055,1864,191,9.3
Fairbanks North Star,AK,46708,43768,2940,6.3
Haines,AK,1089,990,99,9.1
Hoonah-Angoon,AK,1140,996,144,12.6
Juneau,AK,17435,16607,828,4.7
Kenai Peninsula,AK,27095,24795,2300,8.5
Ketchikan Gateway,AK,7104,6656,448,6.3
Kodiak Island,AK,6447,6118,329,5.1
Kusilvak,AK,2805,2242,563,20.1
Lake and Peninsula,AK,723,637,86,11.9
Matanuska-Susitna,AK,47397,43292,4105,8.7
Nome,AK,4089,3575,514,12.6
North Slope,AK,3670,3397,273,7.4
Northwest Arctic,AK,2961,2463,498,16.8
Petersburg,AK,1413,1281,132,9.3
Prince of Wales-Hyder,AK,2836,2512,324,11.4
Sitka,AK,4449,4241,208,4.7
Skagway,AK,824,737,87,10.6
Southeast Fairbanks,AK,2969,2659,310,10.4
Valdez-Cordova,AK,4898,4508,390,8
Wrangell,AK,1050,969,81,7.7
Yakutat,AK,235,213,22,9.4
Yukon-Koyukuk,AK,2486,2032,454,18.3
Apache,AZ,20419,18292,2127,10.4
Cochise,AZ,49373,46602,2771,5.6
Coconino,AZ,75381,71195,4186,5.6
Gila,AZ,21362,20067,1295,6.1
Graham,AZ,14423,13638,785,5.4
Greenlee,AZ,3992,3788,204,5.1
La Paz,AZ,8681,8214,467,5.4
Maricopa,AZ,2134987,2045885,89102,4.2
Mohave,AZ,82407,77579,4828,5.9
Navajo,AZ,41337,38206,3131,7.6
Pima,AZ,475622,454292,21330,4.5
Pinal,AZ,168806,160333,8473,5
Santa Cruz,AZ,19001,17194,1807,9.5
Yavapai,AZ,101763,97180,4583,4.5
Yuma,AZ,95167,78942,16225,17
Arkansas,AR,9013,8719,294,3.3
Ashley,AR,7695,7254,441,5.7
Baxter,AR,16401,15707,694,4.2
Benton,AR,132496,128647,3849,2.9
Boone,AR,15821,15278,543,3.4
Bradley,AR,4379,4174,205,4.7
Calhoun,AR,2361,2268,93,3.9
Carroll,AR,13097,12666,431,3.3
Chicot,AR,3505,3276,229,6.5
Clark,AR,9470,9093,377,4
Clay,AR,5908,5639,269,4.6
Cleburne,AR,9351,8893,458,4.9
Cleveland,AR,3315,3170,145,4.4
Columbia,AR,9115,8655,460,5
Conway,AR,8281,7889,392,4.7
Craighead,AR,53733,52132,1601,3
Crawford,AR,26688,25743,945,3.5
Crittenden,AR,21807,20871,936,4.3
Cross,AR,7724,7417,307,4
Dallas,AR,2881,2751,130,4.5
Desha,AR,5453,5191,262,4.8
Drew,AR,7846,7441,405,5.2
Faulkner,AR,61288,59253,2035,3.3
Franklin,AR,7439,7181,258,3.5
Fulton,AR,4732,4533,199,4.2
Garland,AR,40424,38805,1619,4
Grant,AR,8371,8104,267,3.2
Greene,AR,19805,19082,723,3.7
Hempstead,AR,9897,9555,342,3.5
Hot Spring,AR,14188,13665,523,3.7
Howard,AR,5952,5771,181,3
Independence,AR,16231,15546,685,4.2
Izard,AR,4908,4640,268,5.5
Jackson,AR,5916,5570,346,5.8
Jefferson,AR,28059,26605,1454,5.2
Johnson,AR,10640,10189,451,4.2
Lafayette,AR,2521,2393,128,5.1
Lawrence,AR,6918,6657,261,3.8
Lee,AR,2976,2832,144,4.8
Lincoln,AR,4036,3867,169,4.2
Little River,AR,5591,5323,268,4.8
Logan,AR,8947,8604,343,3.8
Lonoke,AR,33887,32785,1102,3.3
Madison,AR,7458,7249,209,2.8
Marion,AR,6495,6239,256,3.9
Miller,AR,19862,19006,856,4.3
Mississippi,AR,17908,16845,1063,5.9
Monroe,AR,2820,2700,120,4.3
Montgomery,AR,3069,2921,148,4.8
Nevada,AR,3615,3487,128,3.5
Newton,AR,3380,3259,121,3.6
Ouachita,AR,9795,9347,448,4.6
Perry,AR,4202,4027,175,4.2
Phillips,AR,6574,6192,382,5.8
Pike,AR,4285,4111,174,4.1
Poinsett,AR,10347,9921,426,4.1
Polk,AR,8033,7672,361,4.5
Pope,AR,29336,28044,1292,4.4
Prairie,AR,3732,3581,151,4
Pulaski,AR,190086,183669,6417,3.4
Randolph,AR,6936,6648,288,4.2
St. Francis,AR,8410,7983,427,5.1
Saline,AR,57787,56056,1731,3
Scott,AR,4423,4272,151,3.4
Searcy,AR,2946,2812,134,4.5
Sebastian,AR,57210,55146,2064,3.6
Sevier,AR,5650,5395,255,4.5
Sharp,AR,6054,5756,298,4.9
Stone,AR,4827,4598,229,4.7
Union,AR,16138,15285,853,5.3
Van Buren,AR,6089,5759,330,5.4
Washington,AR,122329,119232,3097,2.5
White,AR,33810,32280,1530,4.5
Woodruff,AR,2950,2807,143,4.8
Yell,AR,8650,8304,346,4
Alameda,CA,848335,817433,30902,3.6
Alpine,CA,538,505,33,6.1
Amador,CA,14783,14059,724,4.9
Butte,CA,102982,97066,5916,5.7
Calaveras,CA,21184,20183,1001,4.7
Colusa,CA,10759,9216,1543,14.3
Contra Costa,CA,563863,542445,21418,3.8
Del Norte,CA,9780,9151,629,6.4
El Dorado,CA,89886,85966,3920,4.4
Fresno,CA,449595,411525,38070,8.5
Glenn,CA,12915,11952,963,7.5
Humboldt,CA,63019,60380,2639,4.2
Imperial,CA,73980,59875,14105,19.1
Inyo,CA,8682,8301,381,4.4
Kern,CA,384944,349502,35442,9.2
Kings,CA,57714,52595,5119,8.9
Lake,CA,29714,28008,1706,5.7
Lassen,CA,10005,9447,558,5.6
Los Angeles,CA,5096516,4853818,242698,4.8
Madera,CA,61443,56494,4949,8.1
Marin,CA,141308,137270,4038,2.9
Mariposa,CA,7647,7196,451,5.9
Mendocino,CA,40003,38210,1793,4.5
Merced,CA,116088,105287,10801,9.3
Modoc,CA,3230,2970,260,8
Mono,CA,8568,8188,380,4.4
Monterey,CA,220120,204309,15811,7.2
Napa,CA,73873,71172,2701,3.7
Nevada,CA,48659,46661,1998,4.1
Orange,CA,1618828,1562201,56627,3.5
Placer,CA,182169,175165,7004,3.8
Plumas,CA,7803,7111,692,8.9
Riverside,CA,1073843,1017591,56252,5.2
Sacramento,CA,702049,669469,32580,4.6
San Benito,CA,30317,28552,1765,5.8
San Bernardino,CA,950765,904183,46582,4.9
San Diego,CA,1584655,1521190,63465,4
San Francisco,CA,568722,552223,16499,2.9
San Joaquin,CA,324788,302176,22612,7
San Luis Obispo,CA,142066,136977,5089,3.6
San Mateo,CA,452445,440324,12121,2.7
Santa Barbara,CA,216954,207213,9741,4.5
Santa Clara,CA,1040558,1007143,33415,3.2
Santa Cruz,CA,143802,135648,8154,5.7
Shasta,CA,74476,70155,4321,5.8
Sierra,CA,1301,1216,85,6.5
Siskiyou,CA,17963,16662,1301,7.2
Solano,CA,209199,199257,9942,4.8
Sonoma,CA,262807,253972,8835,3.4
Stanislaus,CA,243235,225070,18165,7.5
Sutter,CA,45739,41804,3935,8.6
Tehama,CA,25598,23968,1630,6.4
Trinity,CA,4991,4690,301,6
Tulare,CA,205423,184022,21401,10.4
Tuolumne,CA,21477,20319,1158,5.4
Ventura,CA,426116,406976,19140,4.5
Yolo,CA,107775,102373,5402,5
Yuba,CA,28546,26421,2125,7.4
Adams,CO,261302,253318,7984,3.1
Alamosa,CO,8230,7948,282,3.4
Arapahoe,CO,351417,341647,9770,2.8
Archuleta,CO,6593,6395,198,3
Baca,CO,2138,2103,35,1.6
Bent,CO,1925,1873,52,2.7
Boulder,CO,186852,182316,4536,2.4
Broomfield,CO,37971,36974,997,2.6
Chaffee,CO,9318,9101,217,2.3
Cheyenne,CO,1145,1125,20,1.7
Clear Creek,CO,5853,5700,153,2.6
Conejos,CO,3920,3755,165,4.2
Costilla,CO,1832,1767,65,3.5
Crowley,CO,1458,1413,45,3.1
Custer,CO,2015,1954,61,3
Delta,CO,14357,13798,559,3.9
Denver,CO,397166,386225,10941,2.8
Dolores,CO,1138,1104,34,3
Douglas,CO,183263,178882,4381,2.4
Eagle,CO,35052,34240,812,2.3
Elbert,CO,14330,13981,349,2.4
El Paso,CO,326663,315997,10666,3.3
Fremont,CO,15084,14437,647,4.3
Garfield,CO,31778,30863,915,2.9
Gilpin,CO,3594,3521,73,2
Grand,CO,9598,9383,215,2.2
Gunnison,CO,10714,10500,214,2
Hinsdale,CO,492,481,11,2.2
Huerfano,CO,2580,2432,148,5.7
Jackson,CO,963,946,17,1.8
Jefferson,CO,325390,316839,8551,2.6
Kiowa,CO,942,925,17,1.8
Kit Carson,CO,4606,4522,84,1.8
Lake,CO,4731,4629,102,2.2
La Plata,CO,31713,30936,777,2.5
Larimer,CO,195084,190337,4747,2.4
Las Animas,CO,6277,6023,254,4
Lincoln,CO,2404,2353,51,2.1
Logan,CO,11213,10950,263,2.3
Mesa,CO,73877,70937,2940,4
Mineral,CO,453,444,9,2
Moffat,CO,7375,7130,245,3.3
Montezuma,CO,12998,12478,520,4
Montrose,CO,20925,20234,691,3.3
Morgan,CO,15716,15332,384,2.4
Otero,CO,8352,8006,346,4.1
Ouray,CO,2291,2225,66,2.9
Park,CO,10153,9909,244,2.4
Phillips,CO,2597,2554,43,1.7
Pitkin,CO,11032,10691,341,3.1
Prowers,CO,6216,6053,163,2.6
Pueblo,CO,74580,71353,3227,4.3
Rio Blanco,CO,2822,2713,109,3.9
Rio Grande,CO,5445,5209,236,4.3
Routt,CO,15577,15206,371,2.4
Saguache,CO,3404,3253,151,4.4
San Juan,CO,538,526,12,2.2
San Miguel,CO,5397,5243,154,2.9
Sedgwick,CO,1214,1187,27,2.2
Summit,CO,22008,21598,410,1.9
Teller,CO,12170,11776,394,3.2
Washington,CO,3054,2995,59,1.9
Weld,CO,157286,153092,4194,2.7
Yuma,CO,5726,5633,93,1.6
Fairfield,CT,485357,463484,21873,4.5
Hartford,CT,481242,457937,23305,4.8
Litchfield,CT,105736,101180,4556,4.3
Middlesex,CT,93686,89889,3797,4.1
New Haven,CT,462382,439130,23252,5
New London,CT,139444,133191,6253,4.5
Tolland,CT,86570,83107,3463,4
Windham,CT,64159,60939,3220,5
Kent,DE,78132,74246,3886,5
New Castle,DE,296289,282959,13330,4.5
Sussex,DE,102929,98223,4706,4.6
District of Columbia,401450,377153,24297,6.1
Alachua,FL,136013,130980,5033,3.7
Baker,FL,11794,11316,478,4.1
Bay,FL,88900,85261,3639,4.1
Bradford,FL,11293,10885,408,3.6
Brevard,FL,268757,257365,11392,4.2
Broward,FL,1026330,986586,39744,3.9
Calhoun,FL,4933,4692,241,4.9
Charlotte,FL,70269,67028,3241,4.6
Citrus,FL,47901,45134,2767,5.8
Clay,FL,104588,100617,3971,3.8
Collier,FL,171979,164974,7005,4.1
Columbia,FL,29419,28160,1259,4.3
DeSoto,FL,13833,13225,608,4.4
Dixie,FL,5800,5536,264,4.6
Duval,FL,483717,463724,19993,4.1
Escambia,FL,144784,138797,5987,4.1
Flagler,FL,46377,44220,2157,4.7
Franklin,FL,4770,4599,171,3.6
Gadsden,FL,18477,17495,982,5.3
Gilchrist,FL,6839,6551,288,4.2
Glades,FL,5043,4782,261,5.2
Gulf,FL,6024,5792,232,3.9
Hamilton,FL,4438,4227,211,4.8
Hardee,FL,9378,8858,520,5.5
Hendry,FL,15652,14518,1134,7.2
Hernando,FL,69356,65799,3557,5.1
Highlands,FL,35921,33902,2019,5.6
Hillsborough,FL,723973,696278,27695,3.8
Holmes,FL,6801,6477,324,4.8
Indian River,FL,63322,60169,3153,5
Jackson,FL,17307,16537,770,4.4
Jefferson,FL,5444,5209,235,4.3
Lafayette,FL,2955,2845,110,3.7
Lake,FL,151015,144864,6151,4.1
Lee,FL,335542,322180,13362,4
Leon,FL,152544,146651,5893,3.9
Levy,FL,16967,16230,737,4.3
Liberty,FL,2632,2514,118,4.5
Madison,FL,7407,7083,324,4.4
Manatee,FL,174945,168161,6784,3.9
Marion,FL,133553,126934,6619,5
Martin,FL,72370,69391,2979,4.1
Miami-Dade,FL,1375601,1312619,62982,4.6
Monroe,FL,45317,43816,1501,3.3
Nassau,FL,39078,37594,1484,3.8
Okaloosa,FL,95850,92613,3237,3.4
Okeechobee,FL,18691,17909,782,4.2
Orange,FL,731398,704715,26683,3.6
Osceola,FL,169949,162768,7181,4.2
Palm Beach,FL,724465,694979,29486,4.1
Pasco,FL,227733,217800,9933,4.4
Pinellas,FL,490061,471855,18206,3.7
Polk,FL,293587,279944,13643,4.6
Putnam,FL,27106,25661,1445,5.3
St. Johns,FL,122964,118889,4075,3.3
St. Lucie,FL,138067,131067,7000,5.1
Santa Rosa,FL,78353,75353,3000,3.8
Sarasota,FL,185793,178650,7143,3.8
Seminole,FL,250562,241507,9055,3.6
Sumter,FL,30293,28465,1828,6
Suwannee,FL,18082,17312,770,4.3
Taylor,FL,8785,8390,395,4.5
Union,FL,4876,4701,175,3.6
Volusia,FL,251509,240636,10873,4.3
Wakulla,FL,14622,14108,514,3.5
Walton,FL,29702,28639,1063,3.6
Washington,FL,9839,9412,427,4.3
Appling,GA,9261,8749,512,5.5
Atkinson,GA,4160,3973,187,4.5
Bacon,GA,5091,4860,231,4.5
Baker,GA,1220,1143,77,6.3
Baldwin,GA,17815,16756,1059,5.9
Banks,GA,9242,8876,366,4
Barrow,GA,38866,37280,1586,4.1
Bartow,GA,49763,47468,2295,4.6
Ben Hill,GA,5511,5078,433,7.9
Berrien,GA,7419,7042,377,5.1
Bibb,GA,69653,65922,3731,5.4
Bleckley,GA,4581,4263,318,6.9
Brantley,GA,7238,6818,420,5.8
Brooks,GA,7158,6835,323,4.5
Bryan,GA,17325,16593,732,4.2
Bulloch,GA,37157,35299,1858,5
Burke,GA,9479,8808,671,7.1
Butts,GA,10684,10167,517,4.8
Calhoun,GA,2236,2119,117,5.2
Camden,GA,20906,19823,1083,5.2
Candler,GA,5270,5051,219,4.2
Carroll,GA,55039,52272,2767,5
Catoosa,GA,33123,31747,1376,4.2
Charlton,GA,4841,4595,246,5.1
Chatham,GA,139026,132767,6259,4.5
Chattahoochee,GA,2088,1935,153,7.3
Chattooga,GA,10632,10128,504,4.7
Cherokee,GA,129987,125131,4856,3.7
Clarke,GA,60980,58078,2902,4.8
Clay,GA,875,797,78,8.9
Clayton,GA,134595,126727,7868,5.8
Clinch,GA,2825,2669,156,5.5
Cobb,GA,423398,406109,17289,4.1
Coffee,GA,18436,17482,954,5.2
Colquitt,GA,22195,21192,1003,4.5
Columbia,GA,72880,69833,3047,4.2
Cook,GA,7732,7375,357,4.6
Coweta,GA,72479,69436,3043,4.2
Crawford,GA,5758,5470,288,5
Crisp,GA,9462,8968,494,5.2
Dade,GA,8282,7918,364,4.4
Dawson,GA,11688,11231,457,3.9
Decatur,GA,11663,11006,657,5.6
DeKalb,GA,394688,375712,18976,4.8
Dodge,GA,7126,6677,449,6.3
Dooly,GA,5105,4843,262,5.1
Dougherty,GA,39080,36689,2391,6.1
Douglas,GA,72367,68825,3542,4.9
Early,GA,4555,4305,250,5.5
Echols,GA,1933,1859,74,3.8
Effingham,GA,29036,27840,1196,4.1
Elbert,GA,7874,7455,419,5.3
Emanuel,GA,8683,8101,582,6.7
Evans,GA,4921,4706,215,4.4
Fannin,GA,11006,10481,525,4.8
Fayette,GA,57431,55086,2345,4.1
Floyd,GA,44296,41986,2310,5.2
Forsyth,GA,114728,110421,4307,3.8
Franklin,GA,10019,9541,478,4.8
Fulton,GA,548023,521549,26474,4.8
Gilmer,GA,11988,11387,601,5
Glascock,GA,1303,1237,66,5.1
Glynn,GA,39838,37951,1887,4.7
Gordon,GA,26745,25503,1242,4.6
Grady,GA,10750,10223,527,4.9
Greene,GA,6817,6466,351,5.1
Gwinnett,GA,482878,462438,20440,4.2
Habersham,GA,19372,18485,887,4.6
Hall,GA,100338,96413,3925,3.9
Hancock,GA,2569,2386,183,7.1
Haralson,GA,12491,11894,597,4.8
Harris,GA,16350,15653,697,4.3
Hart,GA,11259,10758,501,4.4
Heard,GA,5143,4885,258,5
Henry,GA,112204,106742,5462,4.9
Houston,GA,69194,65899,3295,4.8
Irwin,GA,3280,3048,232,7.1
Jackson,GA,35004,33729,1275,3.6
Jasper,GA,6811,6516,295,4.3
Jeff Davis,GA,6159,5788,371,6
Jefferson,GA,6760,6334,426,6.3
Jenkins,GA,3206,2987,219,6.8
Johnson,GA,4003,3797,206,5.1
Jones,GA,14045,13430,615,4.4
Lamar,GA,8126,7665,461,5.7
Lanier,GA,3874,3676,198,5.1
Laurens,GA,19445,18294,1151,5.9
Lee,GA,14956,14324,632,4.2
Liberty,GA,25838,24490,1348,5.2
Lincoln,GA,3578,3389,189,5.3
Long,GA,7703,7321,382,5
Lowndes,GA,51826,49391,2435,4.7
Lumpkin,GA,16756,16083,673,4
McDuffie,GA,8964,8405,559,6.2
McIntosh,GA,6120,5808,312,5.1
Macon,GA,4763,4430,333,7
Madison,GA,13602,13020,582,4.3
Marion,GA,3421,3213,208,6.1
Meriwether,GA,9012,8482,530,5.9
Miller,GA,2840,2711,129,4.5
Mitchell,GA,8538,7995,543,6.4
Monroe,GA,13235,12637,598,4.5
Montgomery,GA,3811,3558,253,6.6
Morgan,GA,9015,8606,409,4.5
Murray,GA,15815,14833,982,6.2
Muscogee,GA,79554,74739,4815,6.1
Newton,GA,51535,48794,2741,5.3
Oconee,GA,19231,18550,681,3.5
Oglethorpe,GA,7212,6902,310,4.3
Paulding,GA,82244,78836,3408,4.1
Peach,GA,11669,10986,683,5.9
Pickens,GA,14857,14220,637,4.3
Pierce,GA,8840,8439,401,4.5
Pike,GA,8667,8280,387,4.5
Polk,GA,18470,17494,976,5.3
Pulaski,GA,4149,3930,219,5.3
Putnam,GA,8145,7670,475,5.8
Quitman,GA,827,778,49,5.9
Rabun,GA,6915,6570,345,5
Randolph,GA,2510,2343,167,6.7
Richmond,GA,86601,81450,5151,5.9
Rockdale,GA,44641,42284,2357,5.3
Schley,GA,2130,2011,119,5.6
Screven,GA,5275,4939,336,6.4
Seminole,GA,3124,2919,205,6.6
Spalding,GA,28529,26870,1659,5.8
Stephens,GA,11020,10438,582,5.3
Stewart,GA,2266,2133,133,5.9
Sumter,GA,12941,12043,898,6.9
Talbot,GA,2797,2625,172,6.1
Taliaferro,GA,572,533,39,6.8
Tattnall,GA,9626,9147,479,5
Taylor,GA,2844,2595,249,8.8
Telfair,GA,4800,4424,376,7.8
Terrell,GA,3759,3534,225,6
Thomas,GA,17273,16255,1018,5.9
Tift,GA,19253,18339,914,4.7
Toombs,GA,12005,11223,782,6.5
Towns,GA,3839,3588,251,6.5
Treutlen,GA,2752,2569,183,6.6
Troup,GA,37665,35996,1669,4.4
Turner,GA,3305,3116,189,5.7
Twiggs,GA,2973,2747,226,7.6
Union,GA,10188,9732,456,4.5
Upson,GA,11295,10669,626,5.5
Walker,GA,30728,29326,1402,4.6
Walton,GA,44747,42813,1934,4.3
Ware,GA,15972,15243,729,4.6
Warren,GA,2725,2563,162,5.9
Washington,GA,7373,6930,443,6
Wayne,GA,11371,10714,657,5.8
Webster,GA,988,913,75,7.6
Wheeler,GA,1758,1601,157,8.9
White,GA,15745,15133,612,3.9
Whitfield,GA,45297,42821,2476,5.5
Wilcox,GA,2742,2579,163,5.9
Wilkes,GA,3836,3618,218,5.7
Wilkinson,GA,3845,3625,220,5.7
Worth,GA,9353,8893,460,4.9
Hawaii,HI,91412,88847,2565,2.8
Honolulu,HI,471330,460776,10554,2.2
Kauai,HI,36132,35273,859,2.4
Maui,HI,86545,84346,2199,2.5
Ada,ID,232954,226485,6469,2.8
Adams,ID,1748,1649,99,5.7
Bannock,ID,41733,40475,1258,3
Bear Lake,ID,2803,2712,91,3.2
Benewah,ID,3993,3772,221,5.5
Bingham,ID,22946,22268,678,3
Blaine,ID,12277,11966,311,2.5
Boise,ID,3200,3047,153,4.8
Bonner,ID,19131,18272,859,4.5
Bonneville,ID,53517,52087,1430,2.7
Boundary,ID,5135,4891,244,4.8
Butte,ID,1314,1274,40,3
Camas,ID,676,658,18,2.7
Canyon,ID,96377,92955,3422,3.6
Caribou,ID,3814,3693,121,3.2
Cassia,ID,11718,11429,289,2.5
Clark,ID,403,392,11,2.7
Clearwater,ID,3039,2830,209,6.9
Custer,ID,2151,2060,91,4.2
Elmore,ID,11144,10741,403,3.6
Franklin,ID,6723,6570,153,2.3
Fremont,ID,7583,7381,202,2.7
Gem,ID,7934,7623,311,3.9
Gooding,ID,8054,7857,197,2.4
Idaho,ID,6246,5937,309,4.9
Jefferson,ID,13057,12730,327,2.5
Jerome,ID,11763,11442,321,2.7
Kootenai,ID,75457,72557,2900,3.8
Latah,ID,20140,19606,534,2.7
Lemhi,ID,3472,3291,181,5.2
Lewis,ID,1604,1510,94,5.9
Lincoln,ID,2710,2623,87,3.2
Madison,ID,21269,20866,403,1.9
Minidoka,ID,11000,10707,293,2.7
Nez Perce,ID,21264,20662,602,2.8
Oneida,ID,2254,2190,64,2.8
Owyhee,ID,5178,4971,207,4
Payette,ID,11512,11061,451,3.9
Power,ID,3952,3818,134,3.4
Shoshone,ID,5041,4725,316,6.3
Teton,ID,6088,5922,166,2.7
Twin Falls,ID,41351,40156,1195,2.9
Valley,ID,5131,4906,225,4.4
Washington,ID,4611,4396,215,4.7
Adams,IL,32237,31008,1229,3.8
Alexander,IL,2161,1989,172,8
Bond,IL,7817,7478,339,4.3
Boone,IL,25978,24269,1709,6.6
Brown,IL,2842,2761,81,2.9
Bureau,IL,17319,16490,829,4.8
Calhoun,IL,2352,2227,125,5.3
Carroll,IL,7607,7263,344,4.5
Cass,IL,6157,5882,275,4.5
Champaign,IL,104527,100100,4427,4.2
Christian,IL,14687,13919,768,5.2
Clark,IL,7845,7470,375,4.8
Clay,IL,6623,6277,346,5.2
Clinton,IL,20251,19547,704,3.5
Coles,IL,24429,23308,1121,4.6
Cook,IL,2653153,2514113,139040,5.2
Crawford,IL,8778,8323,455,5.2
Cumberland,IL,6096,5858,238,3.9
DeKalb,IL,54651,52180,2471,4.5
De Witt,IL,7740,7386,354,4.6
Douglas,IL,10120,9714,406,4
DuPage,IL,515683,494644,21039,4.1
Edgar,IL,9426,8974,452,4.8
Edwards,IL,2838,2710,128,4.5
Effingham,IL,18787,18083,704,3.7
Fayette,IL,9585,9065,520,5.4
Ford,IL,6483,6178,305,4.7
Franklin,IL,16425,15380,1045,6.4
Fulton,IL,15430,14464,966,6.3
Gallatin,IL,2455,2316,139,5.7
Greene,IL,5965,5666,299,5
Grundy,IL,25658,24136,1522,5.9
Hamilton,IL,4416,4221,195,4.4
Hancock,IL,8483,8051,432,5.1
Hardin,IL,1336,1234,102,7.6
Henderson,IL,3643,3461,182,5
Henry,IL,24790,23545,1245,5
Iroquois,IL,14668,14014,654,4.5
Jackson,IL,27990,26759,1231,4.4
Jasper,IL,4520,4302,218,4.8
Jefferson,IL,17341,16406,935,5.4
Jersey,IL,10931,10413,518,4.7
Jo Daviess,IL,11002,10518,484,4.4
Johnson,IL,4084,3785,299,7.3
Kane,IL,267675,255037,12638,4.7
Kankakee,IL,55854,52935,2919,5.2
Kendall,IL,67862,64820,3042,4.5
Knox,IL,22472,21328,1144,5.1
Lake,IL,370972,354622,16350,4.4
LaSalle,IL,55642,52569,3073,5.5
Lawrence,IL,6042,5681,361,6
Lee,IL,17784,17028,756,4.3
Livingston,IL,16611,15882,729,4.4
Logan,IL,12827,12246,581,4.5
McDonough,IL,13485,12827,658,4.9
McHenry,IL,167389,159780,7609,4.5
McLean,IL,88354,84768,3586,4.1
Macon,IL,49202,46514,2688,5.5
Macoupin,IL,23071,21971,1100,4.8
Madison,IL,133452,127266,6186,4.6
Marion,IL,17637,16730,907,5.1
Marshall,IL,5470,5180,290,5.3
Mason,IL,6375,5995,380,6
Massac,IL,5875,5503,372,6.3
Menard,IL,6723,6453,270,4
Mercer,IL,8067,7662,405,5
Monroe,IL,18356,17752,604,3.3
Montgomery,IL,11886,11218,668,5.6
Morgan,IL,16437,15732,705,4.3
Moultrie,IL,7269,6990,279,3.8
Ogle,IL,25178,23911,1267,5
Peoria,IL,85721,80773,4948,5.8
Perry,IL,8319,7828,491,5.9
Piatt,IL,8453,8116,337,4
Pike,IL,7192,6872,320,4.4
Pope,IL,1754,1646,108,6.2
Pulaski,IL,2098,1934,164,7.8
Putnam,IL,2985,2842,143,4.8
Randolph,IL,14114,13501,613,4.3
Richland,IL,7535,7182,353,4.7
Rock Island,IL,70698,67147,3551,5
St. Clair,IL,125758,119566,6192,4.9
Saline,IL,9694,9077,617,6.4
Sangamon,IL,103457,99077,4380,4.2
Schuyler,IL,3286,3141,145,4.4
Scott,IL,2457,2331,126,5.1
Shelby,IL,10235,9784,451,4.4
Stark,IL,2682,2520,162,6
Stephenson,IL,21537,20544,993,4.6
Tazewell,IL,64033,60655,3378,5.3
Union,IL,7354,6891,463,6.3
Vermilion,IL,34070,31928,2142,6.3
Wabash,IL,5596,5322,274,4.9
Warren,IL,8643,8286,357,4.1
Washington,IL,9542,9262,280,2.9
Wayne,IL,6868,6451,417,6.1
White,IL,6645,6327,318,4.8
Whiteside,IL,28039,26712,1327,4.7
Will,IL,361592,342895,18697,5.2
Williamson,IL,31519,29918,1601,5.1
Winnebago,IL,138602,129843,8759,6.3
Woodford,IL,18837,18025,812,4.3
Adams,IN,17235,16784,451,2.6
Allen,IN,180751,174761,5990,3.3
Bartholomew,IN,44516,43307,1209,2.7
Benton,IN,4510,4357,153,3.4
Blackford,IN,5372,5156,216,4
Boone,IN,34993,34001,992,2.8
Brown,IN,7547,7292,255,3.4
Carroll,IN,10027,9684,343,3.4
Cass,IN,17811,17130,681,3.8
Clark,IN,60858,58747,2111,3.5
Clay,IN,12204,11743,461,3.8
Clinton,IN,16913,16392,521,3.1
Crawford,IN,4923,4705,218,4.4
Daviess,IN,15846,15404,442,2.8
Dearborn,IN,25591,24605,986,3.9
Decatur,IN,14681,14254,427,2.9
DeKalb,IN,22211,21561,650,2.9
Delaware,IN,55024,52708,2316,4.2
Dubois,IN,23194,22594,600,2.6
Elkhart,IN,111740,108915,2825,2.5
Fayette,IN,9042,8588,454,5
Floyd,IN,41151,39793,1358,3.3
Fountain,IN,7882,7565,317,4
Franklin,IN,11169,10765,404,3.6
Fulton,IN,9696,9355,341,3.5
Gibson,IN,19037,18475,562,3
Grant,IN,31781,30540,1241,3.9
Greene,IN,13480,12838,642,4.8
Hamilton,IN,175574,170775,4799,2.7
Hancock,IN,38770,37601,1169,3
Harrison,IN,20035,19345,690,3.4
Hendricks,IN,86205,83723,2482,2.9
Henry,IN,22122,21312,810,3.7
Howard,IN,37983,36534,1449,3.8
Huntington,IN,18387,17728,659,3.6
Jackson,IN,22363,21698,665,3
Jasper,IN,16348,15641,707,4.3
Jay,IN,9731,9385,346,3.6
Jefferson,IN,15031,14470,561,3.7
Jennings,IN,13162,12657,505,3.8
Johnson,IN,80529,78158,2371,2.9
Knox,IN,18645,18006,639,3.4
Kosciusko,IN,41408,40280,1128,2.7
LaGrange,IN,19815,19309,506,2.6
Lake,IN,229520,217832,11688,5.1
LaPorte,IN,47624,45495,2129,4.5
Lawrence,IN,20776,19864,912,4.4
Madison,IN,58889,56567,2322,3.9
Marion,IN,482568,465230,17338,3.6
Marshall,IN,23768,23044,724,3
Martin,IN,5114,4960,154,3
Miami,IN,15795,15177,618,3.9
Monroe,IN,67577,65112,2465,3.6
Montgomery,IN,18927,18353,574,3
Morgan,IN,36114,34859,1255,3.5
Newton,IN,6957,6619,338,4.9
Noble,IN,23050,22336,714,3.1
Ohio,IN,3213,3097,116,3.6
Orange,IN,8750,8406,344,3.9
Owen,IN,9162,8763,399,4.4
Parke,IN,7172,6884,288,4
Perry,IN,9235,8883,352,3.8
Pike,IN,6477,6262,215,3.3
Porter,IN,85418,81948,3470,4.1
Posey,IN,13388,12983,405,3
Pulaski,IN,6357,6135,222,3.5
Putnam,IN,16601,15999,602,3.6
Randolph,IN,11801,11312,489,4.1
Ripley,IN,14017,13516,501,3.6
Rush,IN,8909,8637,272,3.1
St. Joseph,IN,133864,129085,4779,3.6
Scott,IN,10486,10089,397,3.8
Shelby,IN,23016,22256,760,3.3
Spencer,IN,10912,10545,367,3.4
Starke,IN,10449,9990,459,4.4
Steuben,IN,19922,19345,577,2.9
Sullivan,IN,8506,8129,377,4.4
Switzerland,IN,4961,4763,198,4
Tippecanoe,IN,94220,91188,3032,3.2
Tipton,IN,8530,8269,261,3.1
Union,IN,3624,3511,113,3.1
Vanderburgh,IN,93131,90106,3025,3.2
Vermillion,IN,7131,6746,385,5.4
Vigo,IN,48600,46534,2066,4.3
Wabash,IN,15115,14585,530,3.5
Warren,IN,4043,3907,136,3.4
Warrick,IN,32433,31412,1021,3.1
Washington,IN,13650,13145,505,3.7
Wayne,IN,30832,29672,1160,3.8
Wells,IN,14158,13741,417,2.9
White,IN,13164,12728,436,3.3
Whitley,IN,17198,16695,503,2.9
Adair,IA,4143,4027,116,2.8
Adams,IA,2132,2081,51,2.4
Allamakee,IA,7520,7217,303,4
Appanoose,IA,6058,5827,231,3.8
Audubon,IA,3176,3077,99,3.1
Benton,IA,13463,13023,440,3.3
Black Hawk,IA,68275,65683,2592,3.8
Boone,IA,14828,14462,366,2.5
Bremer,IA,13664,13277,387,2.8
Buchanan,IA,11031,10674,357,3.2
Buena Vista,IA,11432,11126,306,2.7
Butler,IA,7860,7575,285,3.6
Calhoun,IA,4301,4169,132,3.1
Carroll,IA,11049,10794,255,2.3
Cass,IA,7135,6878,257,3.6
Cedar,IA,10797,10483,314,2.9
Cerro Gordo,IA,23237,22521,716,3.1
Cherokee,IA,6082,5927,155,2.5
Chickasaw,IA,6399,6195,204,3.2
Clarke,IA,4763,4614,149,3.1
Clay,IA,8606,8283,323,3.8
Clayton,IA,10169,9765,404,4
Clinton,IA,23167,22218,949,4.1
Crawford,IA,8220,7880,340,4.1
Dallas,IA,46065,45077,988,2.1
Davis,IA,4254,4112,142,3.3
Decatur,IA,4351,4236,115,2.6
Delaware,IA,10512,10229,283,2.7
Des Moines,IA,19655,18819,836,4.3
Dickinson,IA,10165,9793,372,3.7
Dubuque,IA,54459,52821,1638,3
Emmet,IA,5441,5266,175,3.2
Fayette,IA,10429,10042,387,3.7
Floyd,IA,8777,8492,285,3.2
Franklin,IA,5773,5613,160,2.8
Fremont,IA,3833,3733,100,2.6
Greene,IA,5409,5258,151,2.8
Grundy,IA,6501,6309,192,3
Guthrie,IA,5596,5417,179,3.2
Hamilton,IA,7059,6829,230,3.3
Hancock,IA,6158,5997,161,2.6
Hardin,IA,8474,8200,274,3.2
Harrison,IA,7362,7160,202,2.7
Henry,IA,9681,9392,289,3
Howard,IA,5119,4963,156,3
Humboldt,IA,5273,5112,161,3.1
Ida,IA,4029,3934,95,2.4
Iowa,IA,10478,10201,277,2.6
Jackson,IA,10884,10512,372,3.4
Jasper,IA,19272,18666,606,3.1
Jefferson,IA,8995,8714,281,3.1
Johnson,IA,84887,82775,2112,2.5
Jones,IA,10527,10141,386,3.7
Keokuk,IA,5192,5005,187,3.6
Kossuth,IA,8731,8521,210,2.4
Lee,IA,16168,15277,891,5.5
Linn,IA,118275,114290,3985,3.4
Louisa,IA,6053,5853,200,3.3
Lucas,IA,4364,4240,124,2.8
Lyon,IA,6992,6869,123,1.8
Madison,IA,8315,8015,300,3.6
Mahaska,IA,11468,11092,376,3.3
Marion,IA,17337,16877,460,2.7
Marshall,IA,18248,17406,842,4.6
Mills,IA,7321,7118,203,2.8
Mitchell,IA,5765,5640,125,2.2
Monona,IA,4520,4353,167,3.7
Monroe,IA,3900,3751,149,3.8
Montgomery,IA,4985,4827,158,3.2
Muscatine,IA,21819,21096,723,3.3
O'Brien,IA,8038,7842,196,2.4
Osceola,IA,3579,3504,75,2.1
Page,IA,6284,6032,252,4
Palo Alto,IA,4905,4773,132,2.7
Plymouth,IA,14570,14217,353,2.4
Pocahontas,IA,4118,4016,102,2.5
Polk,IA,259419,251455,7964,3.1
Pottawattamie,IA,48034,46694,1340,2.8
Poweshiek,IA,10440,10110,330,3.2
Ringgold,IA,2569,2490,79,3.1
Sac,IA,5358,5206,152,2.8
Scott,IA,86085,82899,3186,3.7
Shelby,IA,6678,6516,162,2.4
Sioux,IA,20350,19938,412,2
Story,IA,57279,56135,1144,2
Tama,IA,9627,9291,336,3.5
Taylor,IA,3237,3164,73,2.3
Union,IA,6430,6228,202,3.1
Van Buren,IA,3724,3609,115,3.1
Wapello,IA,17641,16837,804,4.6
Warren,IA,27296,26545,751,2.8
Washington,IA,12358,11998,360,2.9
Wayne,IA,2783,2697,86,3.1
Webster,IA,19369,18639,730,3.8
Winnebago,IA,5190,5025,165,3.2
Winneshiek,IA,11839,11470,369,3.1
Woodbury,IA,54218,52480,1738,3.2
Worth,IA,4219,4089,130,3.1
Wright,IA,6552,6325,227,3.5
Allen,KS,6298,5991,307,4.9
Anderson,KS,4144,3980,164,4
Atchison,KS,7055,6690,365,5.2
Barber,KS,2475,2404,71,2.9
Barton,KS,14100,13589,511,3.6
Bourbon,KS,6860,6551,309,4.5
Brown,KS,5327,5156,171,3.2
Butler,KS,31813,30616,1197,3.8
Chase,KS,1404,1367,37,2.6
Chautauqua,KS,1447,1379,68,4.7
Cherokee,KS,10164,9770,394,3.9
Cheyenne,KS,1315,1281,34,2.6
Clark,KS,1104,1076,28,2.5
Clay,KS,3825,3681,144,3.8
Cloud,KS,3895,3725,170,4.4
Coffey,KS,4124,3907,217,5.3
Comanche,KS,922,895,27,2.9
Cowley,KS,16961,16316,645,3.8
Crawford,KS,19123,18323,800,4.2
Decatur,KS,1266,1227,39,3.1
Dickinson,KS,9279,8924,355,3.8
Doniphan,KS,4253,4106,147,3.5
Douglas,KS,65199,63138,2061,3.2
Edwards,KS,1548,1501,47,3
Elk,KS,1193,1142,51,4.3
Ellis,KS,16972,16545,427,2.5
Ellsworth,KS,2708,2624,84,3.1
Finney,KS,20373,19829,544,2.7
Ford,KS,17791,17295,496,2.8
Franklin,KS,14142,13616,526,3.7
Geary,KS,11573,10989,584,5
Gove,KS,1417,1384,33,2.3
Graham,KS,1125,1085,40,3.6
Grant,KS,3478,3367,111,3.2
Gray,KS,3422,3354,68,2
Greeley,KS,880,864,16,1.8
Greenwood,KS,3211,3074,137,4.3
Hamilton,KS,1608,1570,38,2.4
Harper,KS,2654,2555,99,3.7
Harvey,KS,17031,16343,688,4
Haskell,KS,2218,2168,50,2.3
Hodgeman,KS,993,968,25,2.5
Jackson,KS,7181,6956,225,3.1
Jefferson,KS,10104,9744,360,3.6
Jewell,KS,1312,1267,45,3.4
Johnson,KS,332197,322197,10000,3
Kearny,KS,2055,2004,51,2.5
Kingman,KS,3440,3314,126,3.7
Kiowa,KS,1342,1308,34,2.5
Labette,KS,10350,9881,469,4.5
Lane,KS,797,770,27,3.4
Leavenworth,KS,36117,34708,1409,3.9
Lincoln,KS,1689,1641,48,2.8
Linn,KS,4355,4100,255,5.9
Logan,KS,1682,1646,36,2.1
Lyon,KS,16809,16171,638,3.8
McPherson,KS,16290,15841,449,2.8
Marion,KS,6267,6040,227,3.6
Marshall,KS,5490,5337,153,2.8
Meade,KS,2260,2205,55,2.4
Miami,KS,17175,16534,641,3.7
Mitchell,KS,3452,3358,94,2.7
Montgomery,KS,14987,14203,784,5.2
Morris,KS,3013,2919,94,3.1
Morton,KS,1212,1167,45,3.7
Nemaha,KS,5580,5445,135,2.4
Neosho,KS,6053,5736,317,5.2
Ness,KS,1368,1328,40,2.9
Norton,KS,2820,2757,63,2.2
Osage,KS,7961,7646,315,4
Osborne,KS,2008,1952,56,2.8
Ottawa,KS,3060,2966,94,3.1
Pawnee,KS,3035,2934,101,3.3
Phillips,KS,2811,2728,83,3
Pottawatomie,KS,12168,11795,373,3.1
Pratt,KS,4931,4769,162,3.3
Rawlins,KS,1463,1430,33,2.3
Reno,KS,30028,28867,1161,3.9
Republic,KS,2460,2391,69,2.8
Rice,KS,5406,5232,174,3.2
Riley,KS,35023,33974,1049,3
Rooks,KS,2505,2409,96,3.8
Rush,KS,1634,1582,52,3.2
Russell,KS,3501,3384,117,3.3
Saline,KS,30674,29693,981,3.2
Scott,KS,2851,2789,62,2.2
Sedgwick,KS,244662,234327,10335,4.2
Seward,KS,9873,9526,347,3.5
Shawnee,KS,90915,87585,3330,3.7
Sheridan,KS,1363,1332,31,2.3
Sherman,KS,2882,2797,85,2.9
Smith,KS,1971,1916,55,2.8
Stafford,KS,2003,1937,66,3.3
Stanton,KS,992,965,27,2.7
Stevens,KS,2657,2572,85,3.2
Sumner,KS,10761,10352,409,3.8
Thomas,KS,4266,4156,110,2.6
Trego,KS,1435,1387,48,3.3
Wabaunsee,KS,3637,3521,116,3.2
Wallace,KS,847,826,21,2.5
Washington,KS,2962,2873,89,3
Wichita,KS,1168,1140,28,2.4
Wilson,KS,3998,3810,188,4.7
Woodson,KS,1589,1518,71,4.5
Wyandotte,KS,77204,73194,4010,5.2
Adair,KY,6854,6420,434,6.3
Allen,KY,8954,8589,365,4.1
Anderson,KY,11573,11092,481,4.2
Ballard,KY,3650,3371,279,7.6
Barren,KY,19257,18377,880,4.6
Bath,KY,4755,4384,371,7.8
Bell,KY,8790,8100,690,7.8
Boone,KY,68431,65761,2670,3.9
Bourbon,KY,9921,9463,458,4.6
Boyd,KY,18497,17177,1320,7.1
Boyle,KY,12701,12064,637,5
Bracken,KY,3878,3652,226,5.8
Breathitt,KY,3942,3606,336,8.5
Breckinridge,KY,8206,7725,481,5.9
Bullitt,KY,41337,39581,1756,4.2
Butler,KY,5257,4970,287,5.5
Caldwell,KY,5467,5182,285,5.2
Calloway,KY,18597,17771,826,4.4
Campbell,KY,49517,47635,1882,3.8
Carlisle,KY,2432,2266,166,6.8
Carroll,KY,4919,4687,232,4.7
Carter,KY,10232,9253,979,9.6
Casey,KY,6943,6618,325,4.7
Christian,KY,25091,23563,1528,6.1
Clark,KY,17258,16455,803,4.7
Clay,KY,5640,5161,479,8.5
Clinton,KY,3877,3622,255,6.6
Crittenden,KY,4139,3919,220,5.3
Cumberland,KY,2958,2802,156,5.3
Daviess,KY,47366,45269,2097,4.4
Edmonson,KY,4884,4592,292,6
Elliott,KY,2227,2000,227,10.2
Estill,KY,5383,5061,322,6
Fayette,KY,174304,167944,6360,3.6
Fleming,KY,6159,5790,369,6
Floyd,KY,11777,10818,959,8.1
Franklin,KY,24673,23652,1021,4.1
Fulton,KY,2085,1935,150,7.2
Gallatin,KY,3947,3765,182,4.6
Garrard,KY,7744,7373,371,4.8
Grant,KY,11531,10965,566,4.9
Graves,KY,16041,15094,947,5.9
Grayson,KY,10990,10327,663,6
Green,KY,5137,4900,237,4.6
Greenup,KY,13833,12779,1054,7.6
Hancock,KY,4087,3880,207,5.1
Hardin,KY,48370,46134,2236,4.6
Harlan,KY,6948,6294,654,9.4
Harrison,KY,8803,8402,401,4.6
Hart,KY,8257,7896,361,4.4
Henderson,KY,21863,20853,1010,4.6
Henry,KY,8048,7716,332,4.1
Hickman,KY,1931,1793,138,7.1
Hopkins,KY,20168,19193,975,4.8
Jackson,KY,4203,3853,350,8.3
Jefferson,KY,394248,376784,17464,4.4
Jessamine,KY,26051,25058,993,3.8
Johnson,KY,7392,6788,604,8.2
Kenton,KY,86025,82582,3443,4
Knott,KY,4576,4188,388,8.5
Knox,KY,10208,9435,773,7.6
Larue,KY,5967,5681,286,4.8
Laurel,KY,24697,23243,1454,5.9
Lawrence,KY,5123,4668,455,8.9
Lee,KY,1952,1789,163,8.4
Leslie,KY,2789,2508,281,10.1
Letcher,KY,6541,5941,600,9.2
Lewis,KY,4930,4492,438,8.9
Lincoln,KY,9386,8853,533,5.7
Livingston,KY,3766,3482,284,7.5
Logan,KY,12161,11629,532,4.4
Lyon,KY,3107,2932,175,5.6
McCracken,KY,29636,27835,1801,6.1
McCreary,KY,4886,4561,325,6.7
McLean,KY,4401,4170,231,5.2
Madison,KY,45448,43494,1954,4.3
Magoffin,KY,3119,2629,490,15.7
Marion,KY,9589,9197,392,4.1
Marshall,KY,15180,14285,895,5.9
Martin,KY,3315,3073,242,7.3
Mason,KY,7376,6927,449,6.1
Meade,KY,12211,11579,632,5.2
Menifee,KY,2385,2177,208,8.7
Mercer,KY,10114,9622,492,4.9
Metcalfe,KY,4176,4003,173,4.1
Monroe,KY,4857,4671,186,3.8
Montgomery,KY,11829,11052,777,6.6
Morgan,KY,4644,4307,337,7.3
Muhlenberg,KY,11686,10903,783,6.7
Nelson,KY,22487,21500,987,4.4
Nicholas,KY,3455,3270,185,5.4
Ohio,KY,9816,9190,626,6.4
Oldham,KY,32553,31407,1146,3.5
Owen,KY,5581,5341,240,4.3
Owsley,KY,1139,1047,92,8.1
Pendleton,KY,6952,6622,330,4.7
Perry,KY,8648,7936,712,8.2
Pike,KY,20466,18852,1614,7.9
Powell,KY,5120,4782,338,6.6
Pulaski,KY,25539,24115,1424,5.6
Robertson,KY,838,786,52,6.2
Rockcastle,KY,6702,6314,388,5.8
Rowan,KY,10711,10093,618,5.8
Russell,KY,6273,5824,449,7.2
Scott,KY,28401,27339,1062,3.7
Shelby,KY,24212,23333,879,3.6
Simpson,KY,8731,8334,397,4.5
Spencer,KY,9838,9460,378,3.8
Taylor,KY,12174,11604,570,4.7
Todd,KY,5502,5278,224,4.1
Trigg,KY,5863,5525,338,5.8
Trimble,KY,3915,3720,195,5
Union,KY,6191,5821,370,6
Warren,KY,63289,60724,2565,4.1
Washington,KY,6365,6105,260,4.1
Wayne,KY,7602,7025,577,7.6
Webster,KY,5839,5532,307,5.3
Whitley,KY,13726,12927,799,5.8
Wolfe,KY,1967,1790,177,9
Woodford,KY,14876,14390,486,3.3
Acadia,LA,24151,22724,1427,5.9
Allen,LA,9023,8548,475,5.3
Ascension,LA,62243,59580,2663,4.3
Assumption,LA,8960,8299,661,7.4
Avoyelles,LA,15644,14680,964,6.2
Beauregard,LA,14778,13989,789,5.3
Bienville,LA,5629,5289,340,6
Bossier,LA,56871,54310,2561,4.5
Caddo,LA,105707,99592,6115,5.8
Calcasieu,LA,108795,104505,4290,3.9
Caldwell,LA,3866,3644,222,5.7
Cameron,LA,4036,3892,144,3.6
Catahoula,LA,3449,3206,243,7
Claiborne,LA,5877,5561,316,5.4
Concordia,LA,7160,6596,564,7.9
De Soto,LA,10700,10047,653,6.1
East Baton Rouge,LA,232758,222513,10245,4.4
East Carroll,LA,2076,1845,231,11.1
East Feliciana,LA,8110,7722,388,4.8
Evangeline,LA,12590,11844,746,5.9
Franklin,LA,7301,6753,548,7.5
Grant,LA,8189,7672,517,6.3
Iberia,LA,29495,27351,2144,7.3
Iberville,LA,14142,13272,870,6.2
Jackson,LA,7004,6686,318,4.5
Jefferson,LA,215779,206008,9771,4.5
Jefferson Davis,LA,13679,13015,664,4.9
Lafayette,LA,113098,107552,5546,4.9
Lafourche,LA,41795,39604,2191,5.2
LaSalle,LA,6172,5881,291,4.7
Lincoln,LA,21674,20549,1125,5.2
Livingston,LA,68804,65914,2890,4.2
Madison,LA,3823,3513,310,8.1
Morehouse,LA,10420,9587,833,8
Natchitoches,LA,16450,15468,982,6
Orleans,LA,179465,170264,9201,5.1
Ouachita,LA,70946,67215,3731,5.3
Plaquemines,LA,10149,9680,469,4.6
Pointe Coupee,LA,9974,9416,558,5.6
Rapides,LA,56356,53190,3166,5.6
Red River,LA,3862,3660,202,5.2
Richland,LA,8364,7853,511,6.1
Sabine,LA,8802,8318,484,5.5
St. Bernard,LA,19477,18459,1018,5.2
St. Charles,LA,25219,24085,1134,4.5
St. Helena,LA,4386,4098,288,6.6
St. James,LA,9547,8919,628,6.6
St. John the Baptist,LA,19975,18760,1215,6.1
St. Landry,LA,32148,29992,2156,6.7
St. Martin,LA,22562,21190,1372,6.1
St. Mary,LA,20410,18785,1625,8
St. Tammany,LA,117253,112244,5009,4.3
Tangipahoa,LA,55118,52001,3117,5.7
Tensas,LA,1559,1428,131,8.4
Terrebonne,LA,47102,44420,2682,5.7
Union,LA,9147,8636,511,5.6
Vermilion,LA,24349,22895,1454,6
Vernon,LA,16368,15310,1058,6.5
Washington,LA,16976,15997,979,5.8
Webster,LA,14869,13848,1021,6.9
West Baton Rouge,LA,13283,12668,615,4.6
West Carroll,LA,4019,3625,394,9.8
West Feliciana,LA,5330,5106,224,4.2
Winn,LA,5059,4732,327,6.5
Androscoggin,ME,55700,53961,1739,3.1
Aroostook,ME,31616,30094,1522,4.8
Cumberland,ME,165341,161135,4206,2.5
Franklin,ME,14537,13952,585,4
Hancock,ME,29396,28282,1114,3.8
Kennebec,ME,62793,60775,2018,3.2
Knox,ME,20727,20077,650,3.1
Lincoln,ME,17077,16526,551,3.2
Oxford,ME,26917,25901,1016,3.8
Penobscot,ME,77131,74271,2860,3.7
Piscataquis,ME,7543,7240,303,4
Sagadahoc,ME,19398,18875,523,2.7
Somerset,ME,23345,22223,1122,4.8
Waldo,ME,21095,20338,757,3.6
Washington,ME,14070,13379,691,4.9
York,ME,113416,110116,3300,2.9
Allegany,MD,32514,30640,1874,5.8
Anne Arundel,MD,309214,298195,11019,3.6
Baltimore,MD,453197,433601,19596,4.3
Calvert,MD,49925,48123,1802,3.6
Caroline,MD,17936,17167,769,4.3
Carroll,MD,94869,91658,3211,3.4
Cecil,MD,53107,50558,2549,4.8
Charles,MD,85792,82373,3419,4
Dorchester,MD,15743,14844,899,5.7
Frederick,MD,131266,126505,4761,3.6
Garrett,MD,15612,14798,814,5.2
Harford,MD,138729,133327,5402,3.9
Howard,MD,182804,177062,5742,3.1
Kent,MD,10308,9846,462,4.5
Montgomery,MD,557412,539132,18280,3.3
Prince George's,MD,511766,490451,21315,4.2
Queen Anne's,MD,27125,26126,999,3.7
St. Mary's,MD,55310,53104,2206,4
Somerset,MD,9436,8793,643,6.8
Talbot,MD,19752,18963,789,4
Washington,MD,76209,72697,3512,4.6
Wicomico,MD,51488,48566,2922,5.7
Worcester,MD,25699,23514,2185,8.5
Baltimore,MD,294248,276206,18042,6.1
Barnstable,MA,112489,107254,5235,4.7
Berkshire,MA,65153,62327,2826,4.3
Bristol,MA,292342,278472,13870,4.7
Dukes,MA,9468,9007,461,4.9
Essex,MA,414548,398885,15663,3.8
Franklin,MA,39904,38572,1332,3.3
Hampden,MA,223137,211909,11228,5
Hampshire,MA,88508,85479,3029,3.4
Middlesex,MA,885207,858240,26967,3
Nantucket/town,MA,7126,6810,316,4.4
Norfolk,MA,377844,365379,12465,3.3
Plymouth,MA,274224,263530,10694,3.9
Suffolk,MA,433072,418378,14694,3.4
Worcester,MA,434150,417238,16912,3.9
Alcona,MI,3855,3572,283,7.3
Alger,MI,3336,3055,281,8.4
Allegan,MI,61320,58958,2362,3.9
Alpena,MI,13582,12781,801,5.9
Antrim,MI,10162,9482,680,6.7
Arenac,MI,6095,5593,502,8.2
Baraga,MI,3173,2919,254,8
Barry,MI,31125,29866,1259,4
Bay,MI,50995,48120,2875,5.6
Benzie,MI,8919,8331,588,6.6
Berrien,MI,73790,70122,3668,5
Branch,MI,19088,18183,905,4.7
Calhoun,MI,63752,60560,3192,5
Cass,MI,24431,23284,1147,4.7
Charlevoix,MI,13069,12324,745,5.7
Cheboygan,MI,10854,9741,1113,10.3
Chippewa,MI,16451,15164,1287,7.8
Clare,MI,12093,11240,853,7.1
Clinton,MI,40853,39329,1524,3.7
Crawford,MI,5451,5068,383,7
Delta,MI,17038,15940,1098,6.4
Dickinson,MI,12549,11940,609,4.9
Eaton,MI,57498,55093,2405,4.2
Emmet,MI,17676,16502,1174,6.6
Genesee,MI,183109,172577,10532,5.8
Gladwin,MI,9905,9244,661,6.7
Gogebic,MI,6286,5900,386,6.1
Grand Traverse,MI,49856,47732,2124,4.3
Gratiot,MI,18068,17075,993,5.5
Hillsdale,MI,21084,20040,1044,5
Houghton,MI,16542,15539,1003,6.1
Huron,MI,15737,14906,831,5.3
Ingham,MI,150600,143970,6630,4.4
Ionia,MI,29898,28689,1209,4
Iosco,MI,10173,9406,767,7.5
Iron,MI,5213,4873,340,6.5
Isabella,MI,35483,33858,1625,4.6
Jackson,MI,74314,70799,3515,4.7
Kalamazoo,MI,132438,126982,5456,4.1
Kalkaska,MI,7793,7238,555,7.1
Kent,MI,355111,342568,12543,3.5
Keweenaw,MI,940,858,82,8.7
Lake,MI,3772,3465,307,8.1
Lapeer,MI,41114,38906,2208,5.4
Leelanau,MI,10655,10133,522,4.9
Lenawee,MI,47363,45089,2274,4.8
Livingston,MI,101400,98038,3362,3.3
Luce,MI,2431,2263,168,6.9
Mackinac,MI,5282,4741,541,10.2
Macomb,MI,441491,422560,18931,4.3
Manistee,MI,10448,9754,694,6.6
Marquette,MI,32799,30931,1868,5.7
Mason,MI,14163,13340,823,5.8
Mecosta,MI,18905,17808,1097,5.8
Menominee,MI,11018,10464,554,5
Midland,MI,40489,38565,1924,4.8
Missaukee,MI,7033,6613,420,6
Monroe,MI,76449,72736,3713,4.9
Montcalm,MI,28183,26753,1430,5.1
Montmorency,MI,3037,2709,328,10.8
Muskegon,MI,78193,73961,4232,5.4
Newaygo,MI,23456,22282,1174,5
Oakland,MI,662752,639968,22784,3.4
Oceana,MI,12397,11510,887,7.2
Ogemaw,MI,8238,7592,646,7.8
Ontonagon,MI,2166,1969,197,9.1
Osceola,MI,10624,9978,646,6.1
Oscoda,MI,2941,2721,220,7.5
Otsego,MI,11668,10954,714,6.1
Ottawa,MI,157285,152022,5263,3.3
Presque Isle,MI,5190,4697,493,9.5
Roscommon,MI,7957,7248,709,8.9
Saginaw,MI,87662,82820,4842,5.5
St. Clair,MI,75420,71672,3748,5
St. Joseph,MI,28855,27615,1240,4.3
Sanilac,MI,19457,18287,1170,6
Schoolcraft,MI,3370,3082,288,8.5
Shiawassee,MI,33525,31762,1763,5.3
Tuscola,MI,24039,22504,1535,6.4
Van Buren,MI,35459,33395,2064,5.8
Washtenaw,MI,193566,186598,6968,3.6
Wayne,MI,789088,746415,42673,5.4
Wexford,MI,14776,13936,840,5.7
Aitkin,MN,7195,6747,448,6.2
Anoka,MN,195328,188808,6520,3.3
Becker,MN,18589,17817,772,4.2
Beltrami,MN,23722,22567,1155,4.9
Benton,MN,22088,21202,886,4
Big Stone,MN,2599,2485,114,4.4
Blue Earth,MN,40188,39019,1169,2.9
Brown,MN,14473,13935,538,3.7
Carlton,MN,17854,16997,857,4.8
Carver,MN,57261,55589,1672,2.9
Cass,MN,14554,13702,852,5.9
Chippewa,MN,6969,6688,281,4
Chisago,MN,29638,28467,1171,4
Clay,MN,35875,34723,1152,3.2
Clearwater,MN,4631,4229,402,8.7
Cook,MN,3194,3075,119,3.7
Cottonwood,MN,5636,5335,301,5.3
Crow Wing,MN,32486,31036,1450,4.5
Dakota,MN,239345,232117,7228,3
Dodge,MN,11657,11261,396,3.4
Douglas,MN,20653,19995,658,3.2
Faribault,MN,7235,6930,305,4.2
Fillmore,MN,11521,11119,402,3.5
Freeborn,MN,16182,15589,593,3.7
Goodhue,MN,26916,26042,874,3.2
Grant,MN,3281,3146,135,4.1
Hennepin,MN,698457,677339,21118,3
Houston,MN,10613,10254,359,3.4
Hubbard,MN,9924,9372,552,5.6
Isanti,MN,21034,20124,910,4.3
Itasca,MN,21781,20254,1527,7
Jackson,MN,5779,5568,211,3.7
Kanabec,MN,9022,8474,548,6.1
Kandiyohi,MN,24834,24023,811,3.3
Kittson,MN,2381,2291,90,3.8
Koochiching,MN,6026,5602,424,7
Lac qui Parle,MN,3528,3404,124,3.5
Lake,MN,5591,5373,218,3.9
Lake of the Woods,MN,2387,2275,112,4.7
Le Sueur,MN,15803,15066,737,4.7
Lincoln,MN,3321,3210,111,3.3
Lyon,MN,14987,14506,481,3.2
McLeod,MN,19578,18831,747,3.8
Mahnomen,MN,2367,2250,117,4.9
Marshall,MN,5498,5111,387,7
Martin,MN,10424,10057,367,3.5
Meeker,MN,13301,12761,540,4.1
Mille Lacs,MN,12918,12205,713,5.5
Morrison,MN,17713,16765,948,5.4
Mower,MN,20575,19991,584,2.8
Murray,MN,4898,4686,212,4.3
Nicollet,MN,20625,20101,524,2.5
Nobles,MN,11344,10981,363,3.2
Norman,MN,3408,3246,162,4.8
Olmsted,MN,86420,84085,2335,2.7
Otter Tail,MN,31757,30498,1259,4
Pennington,MN,8831,8326,505,5.7
Pine,MN,15044,14198,846,5.6
Pipestone,MN,4909,4741,168,3.4
Polk,MN,17043,16321,722,4.2
Pope,MN,6371,6176,195,3.1
Ramsey,MN,287472,278210,9262,3.2
Red Lake,MN,2255,2107,148,6.6
Redwood,MN,7702,7385,317,4.1
Renville,MN,8900,8500,400,4.5
Rice,MN,36629,35466,1163,3.2
Rock,MN,5912,5790,122,2.1
Roseau,MN,8157,7758,399,4.9
St. Louis,MN,102698,97937,4761,4.6
Scott,MN,82194,79824,2370,2.9
Sherburne,MN,51601,49675,1926,3.7
Sibley,MN,8513,8208,305,3.6
Stearns,MN,90157,87116,3041,3.4
Steele,MN,20561,19867,694,3.4
Stevens,MN,5526,5379,147,2.7
Swift,MN,5045,4838,207,4.1
Todd,MN,13476,12938,538,4
Traverse,MN,1789,1726,63,3.5
Wabasha,MN,12078,11674,404,3.3
Wadena,MN,5831,5502,329,5.6
Waseca,MN,9392,9025,367,3.9
Washington,MN,141336,137106,4230,3
Watonwan,MN,6491,6205,286,4.4
Wilkin,MN,3574,3462,112,3.1
Winona,MN,29057,28152,905,3.1
Wright,MN,74355,71749,2606,3.5
Yellow Medicine,MN,5345,5156,189,3.5
Adams,MS,11205,10388,817,7.3
Alcorn,MS,16095,15387,708,4.4
Amite,MS,4509,4209,300,6.7
Attala,MS,6938,6512,426,6.1
Benton,MS,3054,2885,169,5.5
Bolivar,MS,12985,12147,838,6.5
Calhoun,MS,6130,5866,264,4.3
Carroll,MS,3597,3388,209,5.8
Chickasaw,MS,7075,6704,371,5.2
Choctaw,MS,3677,3498,179,4.9
Claiborne,MS,3034,2737,297,9.8
Clarke,MS,6033,5661,372,6.2
Clay,MS,7852,7322,530,6.7
Coahoma,MS,8923,8269,654,7.3
Copiah,MS,11310,10670,640,5.7
Covington,MS,8261,7863,398,4.8
DeSoto,MS,88199,84855,3344,3.8
Forrest,MS,33967,32337,1630,4.8
Franklin,MS,2833,2641,192,6.8
George,MS,8914,8285,629,7.1
Greene,MS,4372,4044,328,7.5
Grenada,MS,9653,9209,444,4.6
Hancock,MS,18911,17886,1025,5.4
Harrison,MS,86789,82636,4153,4.8
Hinds,MS,110762,105429,5333,4.8
Holmes,MS,5789,5237,552,9.5
Humphreys,MS,2308,2098,210,9.1
Issaquena,MS,396,350,46,11.6
Itawamba,MS,10385,9942,443,4.3
Jackson,MS,59121,55670,3451,5.8
Jasper,MS,6100,5699,401,6.6
Jefferson,MS,2093,1785,308,14.7
Jefferson Davis,MS,4217,3927,290,6.9
Jones,MS,25476,24165,1311,5.1
Kemper,MS,3511,3233,278,7.9
Lafayette,MS,26766,25631,1135,4.2
Lamar,MS,30205,29049,1156,3.8
Lauderdale,MS,31618,29897,1721,5.4
Lawrence,MS,4643,4339,304,6.5
Leake,MS,7683,7251,432,5.6
Lee,MS,40783,39130,1653,4.1
Leflore,MS,10414,9648,766,7.4
Lincoln,MS,14579,13819,760,5.2
Lowndes,MS,25384,24016,1368,5.4
Madison,MS,53841,51767,2074,3.9
Marion,MS,10233,9667,566,5.5
Marshall,MS,14624,13881,743,5.1
Monroe,MS,15432,14631,801,5.2
Montgomery,MS,4173,3961,212,5.1
Neshoba,MS,10576,10039,537,5.1
Newton,MS,8511,8054,457,5.4
Noxubee,MS,3923,3633,290,7.4
Oktibbeha,MS,22878,21771,1107,4.8
Panola,MS,13039,12157,882,6.8
Pearl River,MS,23243,22016,1227,5.3
Perry,MS,4430,4153,277,6.3
Pike,MS,14690,13812,878,6
Pontotoc,MS,14424,13862,562,3.9
Prentiss,MS,11118,10606,512,4.6
Quitman,MS,2485,2268,217,8.7
Rankin,MS,75655,72957,2698,3.6
Scott,MS,13403,12866,537,4
Sharkey,MS,1703,1572,131,7.7
Simpson,MS,10997,10466,531,4.8
Smith,MS,6752,6434,318,4.7
Stone,MS,6570,6172,398,6.1
Sunflower,MS,8091,7425,666,8.2
Tallahatchie,MS,5631,5333,298,5.3
Tate,MS,12138,11530,608,5
Tippah,MS,9486,9061,425,4.5
Tishomingo,MS,8308,7893,415,5
Tunica,MS,4597,4330,267,5.8
Union,MS,13976,13474,502,3.6
Walthall,MS,5008,4667,341,6.8
Warren,MS,20649,19467,1182,5.7
Washington,MS,17237,15956,1281,7.4
Wayne,MS,7505,7034,471,6.3
Webster,MS,3908,3704,204,5.2
Wilkinson,MS,2836,2589,247,8.7
Winston,MS,7245,6813,432,6
Yalobusha,MS,5005,4730,275,5.5
Yazoo,MS,9212,8657,555,6
Adair,MO,10204,9759,445,4.4
Andrew,MO,9919,9608,311,3.1
Atchison,MO,2817,2718,99,3.5
Audrain,MO,10937,10550,387,3.5
Barry,MO,15109,14590,519,3.4
Barton,MO,5116,4901,215,4.2
Bates,MO,8116,7762,354,4.4
Benton,MO,7120,6751,369,5.2
Bollinger,MO,5382,5144,238,4.4
Boone,MO,97496,94953,2543,2.6
Buchanan,MO,46169,44568,1601,3.5
Butler,MO,18085,17250,835,4.6
Caldwell,MO,4465,4286,179,4
Callaway,MO,21514,20768,746,3.5
Camden,MO,18475,17586,889,4.8
Cape Girardeau,MO,40154,38772,1382,3.4
Carroll,MO,4716,4520,196,4.2
Carter,MO,2471,2323,148,6
Cass,MO,54502,52605,1897,3.5
Cedar,MO,5667,5434,233,4.1
Chariton,MO,3780,3648,132,3.5
Christian,MO,43119,41790,1329,3.1
Clark,MO,3160,2981,179,5.7
Clay,MO,134548,129721,4827,3.6
Clinton,MO,11051,10619,432,3.9
Cole,MO,38860,37720,1140,2.9
Cooper,MO,7348,7077,271,3.7
Crawford,MO,10644,10146,498,4.7
Dade,MO,3544,3423,121,3.4
Dallas,MO,6917,6593,324,4.7
Daviess,MO,4031,3897,134,3.3
DeKalb,MO,5031,4839,192,3.8
Dent,MO,6040,5782,258,4.3
Douglas,MO,4971,4736,235,4.7
Dunklin,MO,12219,11406,813,6.7
Franklin,MO,52277,50386,1891,3.6
Gasconade,MO,7678,7378,300,3.9
Gentry,MO,3572,3470,102,2.9
Greene,MO,147999,143497,4502,3
Grundy,MO,4744,4572,172,3.6
Harrison,MO,3863,3726,137,3.5
Henry,MO,9663,9258,405,4.2
Hickory,MO,3691,3525,166,4.5
Holt,MO,2669,2591,78,2.9
Howard,MO,4987,4795,192,3.9
Howell,MO,15467,14709,758,4.9
Iron,MO,3486,3258,228,6.5
Jackson,MO,363854,348003,15851,4.4
Jasper,MO,56734,54838,1896,3.3
Jefferson,MO,116746,112586,4160,3.6
Johnson,MO,23157,22133,1024,4.4
Knox,MO,1956,1892,64,3.3
Laclede,MO,16189,15401,788,4.9
Lafayette,MO,17206,16563,643,3.7
Lawrence,MO,17564,16930,634,3.6
Lewis,MO,5056,4879,177,3.5
Lincoln,MO,26985,26015,970,3.6
Linn,MO,5169,4864,305,5.9
Livingston,MO,7290,7069,221,3
McDonald,MO,10573,10195,378,3.6
Macon,MO,7403,7130,273,3.7
Madison,MO,5367,5117,250,4.7
Maries,MO,3860,3691,169,4.4
Marion,MO,14321,13800,521,3.6
Mercer,MO,1936,1863,73,3.8
Miller,MO,11823,11289,534,4.5
Mississippi,MO,5972,5668,304,5.1
Moniteau,MO,7361,7097,264,3.6
Monroe,MO,3985,3811,174,4.4
Montgomery,MO,5582,5397,185,3.3
Morgan,MO,7794,7404,390,5
New Madrid,MO,7888,7358,530,6.7
Newton,MO,27750,26751,999,3.6
Nodaway,MO,10485,10101,384,3.7
Oregon,MO,3971,3786,185,4.7
Osage,MO,7141,6927,214,3
Ozark,MO,3527,3319,208,5.9
Pemiscot,MO,6474,5984,490,7.6
Perry,MO,9924,9656,268,2.7
Pettis,MO,20388,19524,864,4.2
Phelps,MO,19311,18576,735,3.8
Pike,MO,7829,7556,273,3.5
Platte,MO,56864,55058,1806,3.2
Polk,MO,14117,13555,562,4
Pulaski,MO,14367,13732,635,4.4
Putnam,MO,2405,2312,93,3.9
Ralls,MO,5520,5344,176,3.2
Randolph,MO,10083,9619,464,4.6
Ray,MO,11205,10672,533,4.8
Reynolds,MO,3056,2932,124,4.1
Ripley,MO,5134,4840,294,5.7
St. Charles,MO,219820,213516,6304,2.9
St. Clair,MO,3789,3592,197,5.2
Ste. Genevieve,MO,8944,8617,327,3.7
St. Francois,MO,26250,25087,1163,4.4
St. Louis,MO,527507,509429,18078,3.4
Saline,MO,10445,10063,382,3.7
Schuyler,MO,1873,1780,93,5
Scotland,MO,2410,2333,77,3.2
Scott,MO,19781,18885,896,4.5
Shannon,MO,3199,3002,197,6.2
Shelby,MO,3047,2941,106,3.5
Stoddard,MO,12992,12325,667,5.1
Stone,MO,13474,12719,755,5.6
Sullivan,MO,2710,2598,112,4.1
Taney,MO,26488,24877,1611,6.1
Texas,MO,9251,8789,462,5
Vernon,MO,9498,9130,368,3.9
Warren,MO,17326,16771,555,3.2
Washington,MO,10155,9601,554,5.5
Wayne,MO,5436,5157,279,5.1
Webster,MO,16764,16118,646,3.9
Worth,MO,1160,1130,30,2.6
Wright,MO,7539,7163,376,5
St. Louis,MO,155752,148881,6871,4.4
Beaverhead,MT,5060,4902,158,3.1
Big Horn,MT,5534,4791,743,13.4
Blaine,MT,2347,2251,96,4.1
Broadwater,MT,2570,2449,121,4.7
Carbon,MT,5411,5212,199,3.7
Carter,MT,697,679,18,2.6
Cascade,MT,37886,36457,1429,3.8
Chouteau,MT,2500,2418,82,3.3
Custer,MT,6202,6005,197,3.2
Daniels,MT,915,894,21,2.3
Dawson,MT,4687,4539,148,3.2
Deer Lodge,MT,5134,4951,183,3.6
Fallon,MT,1755,1708,47,2.7
Fergus,MT,5789,5555,234,4
Flathead,MT,46773,44321,2452,5.2
Gallatin,MT,64315,62540,1775,2.8
Garfield,MT,770,748,22,2.9
Glacier,MT,5741,5284,457,8
Golden Valley,MT,380,361,19,5
Granite,MT,1621,1526,95,5.9
Hill,MT,7835,7537,298,3.8
Jefferson,MT,5645,5402,243,4.3
Judith Basin,MT,927,893,34,3.7
Lake,MT,13194,12608,586,4.4
Lewis and Clark,MT,35227,34006,1221,3.5
Liberty,MT,981,951,30,3.1
Lincoln,MT,7875,7206,669,8.5
McCone,MT,1020,998,22,2.2
Madison,MT,4329,4158,171,4
Meagher,MT,915,874,41,4.5
Mineral,MT,1680,1553,127,7.6
Missoula,MT,62294,60041,2253,3.6
Musselshell,MT,2297,2195,102,4.4
Park,MT,8631,8284,347,4
Petroleum,MT,277,264,13,4.7
Phillips,MT,1898,1812,86,4.5
Pondera,MT,2760,2653,107,3.9
Powder River,MT,1014,988,26,2.6
Powell,MT,2892,2766,126,4.4
Prairie,MT,499,481,18,3.6
Ravalli,MT,19786,18864,922,4.7
Richland,MT,6058,5830,228,3.8
Roosevelt,MT,4597,4382,215,4.7
Rosebud,MT,4035,3826,209,5.2
Sanders,MT,4805,4471,334,7
Sheridan,MT,1898,1846,52,2.7
Silver Bow,MT,17149,16426,723,4.2
Stillwater,MT,4839,4652,187,3.9
Sweet Grass,MT,1788,1732,56,3.1
Teton,MT,2778,2668,110,4
Toole,MT,2156,2089,67,3.1
Treasure,MT,345,332,13,3.8
Valley,MT,4188,4051,137,3.3
Wheatland,MT,781,747,34,4.4
Wibaux,MT,492,476,16,3.3
Yellowstone,MT,81485,78627,2858,3.5
Adams,NE,16548,16034,514,3.1
Antelope,NE,3531,3443,88,2.5
Arthur,NE,223,211,12,5.4
Banner,NE,397,382,15,3.8
Blaine,NE,262,251,11,4.2
Boone,NE,2914,2842,72,2.5
Box Butte,NE,5566,5384,182,3.3
Boyd,NE,1078,1042,36,3.3
Brown,NE,1387,1342,45,3.2
Buffalo,NE,27050,26392,658,2.4
Burt,NE,3477,3348,129,3.7
Butler,NE,4544,4418,126,2.8
Cass,NE,13144,12729,415,3.2
Cedar,NE,4452,4351,101,2.3
Chase,NE,2287,2244,43,1.9
Cherry,NE,3381,3302,79,2.3
Cheyenne,NE,5127,4977,150,2.9
Clay,NE,3259,3158,101,3.1
Colfax,NE,5546,5413,133,2.4
Cuming,NE,4714,4586,128,2.7
Custer,NE,6335,6198,137,2.2
Dakota,NE,10648,10215,433,4.1
Dawes,NE,5158,5016,142,2.8
Dawson,NE,12855,12488,367,2.9
Deuel,NE,1034,1007,27,2.6
Dixon,NE,2989,2894,95,3.2
Dodge,NE,19279,18737,542,2.8
Douglas,NE,288566,279395,9171,3.2
Dundy,NE,1185,1157,28,2.4
Fillmore,NE,3120,3041,79,2.5
Franklin,NE,1476,1431,45,3
Frontier,NE,1555,1515,40,2.6
Furnas,NE,2662,2597,65,2.4
Gage,NE,10886,10503,383,3.5
Garden,NE,1190,1157,33,2.8
Garfield,NE,1150,1121,29,2.5
Gosper,NE,1037,1010,27,2.6
Grant,NE,438,428,10,2.3
Greeley,NE,1214,1176,38,3.1
Hall,NE,31452,30368,1084,3.4
Hamilton,NE,4638,4521,117,2.5
Harlan,NE,1751,1706,45,2.6
Hayes,NE,569,555,14,2.5
Hitchcock,NE,1225,1183,42,3.4
Holt,NE,5738,5597,141,2.5
Hooker,NE,399,384,15,3.8
Howard,NE,3291,3190,101,3.1
Jefferson,NE,4166,4064,102,2.4
Johnson,NE,2060,1990,70,3.4
Kearney,NE,3740,3657,83,2.2
Keith,NE,4553,4415,138,3
Keya Paha,NE,605,590,15,2.5
Kimball,NE,1957,1901,56,2.9
Knox,NE,4691,4528,163,3.5
Lancaster,NE,168999,164538,4461,2.6
Lincoln,NE,18518,17957,561,3
Logan,NE,469,456,13,2.8
Loup,NE,392,380,12,3.1
McPherson,NE,447,437,10,2.2
Madison,NE,19116,18612,504,2.6
Merrick,NE,3998,3886,112,2.8
Morrill,NE,2608,2532,76,2.9
Nance,NE,2011,1961,50,2.5
Nemaha,NE,3579,3439,140,3.9
Nuckolls,NE,2348,2286,62,2.6
Otoe,NE,8110,7838,272,3.4
Pawnee,NE,1497,1451,46,3.1
Perkins,NE,1794,1759,35,2
Phelps,NE,4908,4793,115,2.3
Pierce,NE,4104,3993,111,2.7
Platte,NE,17160,16667,493,2.9
Polk,NE,2864,2796,68,2.4
Red Willow,NE,5805,5658,147,2.5
Richardson,NE,4203,4065,138,3.3
Rock,NE,887,864,23,2.6
Saline,NE,7333,7107,226,3.1
Sarpy,NE,92240,89675,2565,2.8
Saunders,NE,10858,10554,304,2.8
Scotts Bluff,NE,18352,17724,628,3.4
Seward,NE,8719,8487,232,2.7
Sheridan,NE,2685,2614,71,2.6
Sherman,NE,1668,1620,48,2.9
Sioux,NE,765,742,23,3
Stanton,NE,3445,3348,97,2.8
Thayer,NE,2848,2784,64,2.2
Thomas,NE,441,427,14,3.2
Thurston,NE,2988,2839,149,5
Valley,NE,2100,2044,56,2.7
Washington,NE,11113,10770,343,3.1
Wayne,NE,5635,5497,138,2.4
Webster,NE,1669,1619,50,3
Wheeler,NE,565,552,13,2.3
York,NE,7281,7094,187,2.6
Churchill,NV,10782,10306,476,4.4
Clark,NV,1072593,1016396,56197,5.2
Douglas,NV,22769,21676,1093,4.8
Elko,NV,27304,26295,1009,3.7
Esmeralda,NV,524,504,20,3.8
Eureka,NV,1049,1017,32,3.1
Humboldt,NV,8303,7956,347,4.2
Lander,NV,3171,3027,144,4.5
Lincoln,NV,2053,1957,96,4.7
Lyon,NV,22090,20774,1316,6
Mineral,NV,1996,1887,109,5.5
Nye,NV,16403,15356,1047,6.4
Pershing,NV,2645,2526,119,4.5
Storey,NV,1969,1871,98,5
Washoe,NV,239119,229118,10001,4.2
White Pine,NV,4572,4388,184,4
Carson,NV,25610,24316,1294,5.1
Belknap,NH,30857,30044,813,2.6
Carroll,NH,23352,22737,615,2.6
Cheshire,NH,40461,39416,1045,2.6
Coos,NH,14376,13883,493,3.4
Grafton,NH,48495,47437,1058,2.2
Hillsborough,NH,231152,224597,6555,2.8
Merrimack,NH,81116,79203,1913,2.4
Rockingham,NH,181322,176081,5241,2.9
Strafford,NH,72363,70660,1703,2.4
Sullivan,NH,23057,22550,507,2.2
Atlantic,NJ,121102,112399,8703,7.2
Bergen,NJ,483324,464527,18797,3.9
Burlington,NJ,234179,224582,9597,4.1
Camden,NJ,256929,243835,13094,5.1
Cape May,NJ,47088,42780,4308,9.1
Cumberland,NJ,66406,61789,4617,7
Essex,NJ,370503,349489,21014,5.7
Gloucester,NJ,151568,144412,7156,4.7
Hudson,NJ,362646,346777,15869,4.4
Hunterdon,NJ,64722,62437,2285,3.5
Mercer,NJ,198846,190683,8163,4.1
Middlesex,NJ,442313,424201,18112,4.1
Monmouth,NJ,330689,317076,13613,4.1
Morris,NJ,259911,250447,9464,3.6
Ocean,NJ,271129,258063,13066,4.8
Passaic,NJ,245454,231482,13972,5.7
Salem,NJ,29891,28061,1830,6.1
Somerset,NJ,173325,166730,6595,3.8
Sussex,NJ,75277,71981,3296,4.4
Union,NJ,276968,263748,13220,4.8
Warren,NJ,56567,54211,2356,4.2
Bernalillo,NM,326340,308474,17866,5.5
Catron,NM,1154,1074,80,6.9
Chaves,NM,27274,25517,1757,6.4
Cibola,NM,9081,8368,713,7.9
Colfax,NM,5663,5321,342,6
Curry,NM,22018,20952,1066,4.8
De Baca,NM,840,802,38,4.5
Dona Ana,NM,93805,87360,6445,6.9
Eddy,NM,28871,27348,1523,5.3
Grant,NM,12154,11405,749,6.2
Guadalupe,NM,1636,1531,105,6.4
Harding,NM,275,257,18,6.5
Hidalgo,NM,2107,1998,109,5.2
Lea,NM,27554,25744,1810,6.6
Lincoln,NM,8657,8179,478,5.5
Los Alamos,NM,9056,8715,341,3.8
Luna,NM,10454,8979,1475,14.1
McKinley,NM,24237,22130,2107,8.7
Mora,NM,2184,2012,172,7.9
Otero,NM,24778,23265,1513,6.1
Quay,NM,3211,3011,200,6.2
Rio Arriba,NM,16708,15632,1076,6.4
Roosevelt,NM,7937,7518,419,5.3
Sandoval,NM,63918,59972,3946,6.2
San Juan,NM,53194,49349,3845,7.2
San Miguel,NM,10852,10045,807,7.4
Santa Fe,NM,72851,69133,3718,5.1
Sierra,NM,4094,3770,324,7.9
Socorro,NM,6490,6066,424,6.5
Taos,NM,14979,13790,1189,7.9
Torrance,NM,5484,5010,474,8.6
Union,NM,1870,1799,71,3.8
Valencia,NM,29846,27857,1989,6.7
Albany,NY,159950,153134,6816,4.3
Allegany,NY,19858,18527,1331,6.7
Bronx,NY,621649,583116,38533,6.2
Broome,NY,85835,81016,4819,5.6
Cattaraugus,NY,34668,32502,2166,6.2
Cayuga,NY,36134,34291,1843,5.1
Chautauqua,NY,55854,52460,3394,6.1
Chemung,NY,35872,33865,2007,5.6
Chenango,NY,22593,21372,1221,5.4
Clinton,NY,36268,34322,1946,5.4
Columbia,NY,31457,30249,1208,3.8
Cortland,NY,23103,21746,1357,5.9
Delaware,NY,19104,18026,1078,5.6
Dutchess,NY,144725,138458,6267,4.3
Erie,NY,448645,425362,23283,5.2
Essex,NY,17310,16348,962,5.6
Franklin,NY,19982,18769,1213,6.1
Fulton,NY,23317,21954,1363,5.8
Genesee,NY,29723,28275,1448,4.9
Greene,NY,20757,19665,1092,5.3
Hamilton,NY,2328,2152,176,7.6
Herkimer,NY,28294,26660,1634,5.8
Jefferson,NY,45455,42477,2978,6.6
Kings,NY,1245943,1188114,57829,4.6
Lewis,NY,11727,10939,788,6.7
Livingston,NY,31071,29492,1579,5.1
Madison,NY,32802,30972,1830,5.6
Monroe,NY,364394,346201,18193,5
Montgomery,NY,22656,21343,1313,5.8
Nassau,NY,707997,678632,29365,4.1
New York,NY,939689,901733,37956,4
Niagara,NY,101134,94850,6284,6.2
Oneida,NY,102069,96875,5194,5.1
Onondaga,NY,221699,211199,10500,4.7
Ontario,NY,55175,52668,2507,4.5
Orange,NY,181557,173213,8344,4.6
Orleans,NY,17796,16738,1058,5.9
Oswego,NY,53334,49850,3484,6.5
Otsego,NY,28231,26796,1435,5.1
Putnam,NY,51333,49150,2183,4.3
Queens,NY,1190292,1143025,47267,4
Rensselaer,NY,82277,78608,3669,4.5
Richmond,NY,226924,216508,10416,4.6
Rockland,NY,154508,147720,6788,4.4
St. Lawrence,NY,43612,40661,2951,6.8
Saratoga,NY,118482,113720,4762,4
Schenectady,NY,76475,73008,3467,4.5
Schoharie,NY,14823,14005,818,5.5
Schuyler,NY,8291,7804,487,5.9
Seneca,NY,16266,15518,748,4.6
Steuben,NY,43104,40603,2501,5.8
Suffolk,NY,782689,747145,35544,4.5
Sullivan,NY,34590,32885,1705,4.9
Tioga,NY,22978,21788,1190,5.2
Tompkins,NY,50395,48184,2211,4.4
Ulster,NY,88895,84798,4097,4.6
Warren,NY,32188,30476,1712,5.3
Washington,NY,28504,27166,1338,4.7
Wayne,NY,44024,41803,2221,5
Westchester,NY,484107,462054,22053,4.6
Wyoming,NY,18086,17057,1029,5.7
Yates,NY,11702,11179,523,4.5
Alamance,NC,79767,76334,3433,4.3
Alexander,NC,18159,17492,667,3.7
Alleghany,NC,4324,4101,223,5.2
Anson,NC,10545,9985,560,5.3
Ashe,NC,12709,12178,531,4.2
Avery,NC,7697,7362,335,4.4
Beaufort,NC,20100,19068,1032,5.1
Bertie,NC,8177,7680,497,6.1
Bladen,NC,14462,13599,863,6
Brunswick,NC,51242,48341,2901,5.7
Buncombe,NC,136994,132216,4778,3.5
Burke,NC,40584,38848,1736,4.3
Cabarrus,NC,104403,100064,4339,4.2
Caldwell,NC,36528,34877,1651,4.5
Camden,NC,4680,4471,209,4.5
Carteret,NC,32040,30599,1441,4.5
Caswell,NC,9731,9258,473,4.9
Catawba,NC,78425,75123,3302,4.2
Chatham,NC,35166,33801,1365,3.9
Cherokee,NC,11157,10591,566,5.1
Chowan,NC,5617,5310,307,5.5
Clay,NC,3958,3759,199,5
Cleveland,NC,47537,45295,2242,4.7
Columbus,NC,22324,21079,1245,5.6
Craven,NC,41845,39861,1984,4.7
Cumberland,NC,127617,120278,7339,5.8
Currituck,NC,13285,12692,593,4.5
Dare,NC,20162,18962,1200,6
Davidson,NC,80147,76663,3484,4.3
Davie,NC,20330,19508,822,4
Duplin,NC,25578,24317,1261,4.9
Durham,NC,165496,158750,6746,4.1
Edgecombe,NC,22132,20409,1723,7.8
Forsyth,NC,184234,176075,8159,4.4
Franklin,NC,30122,28716,1406,4.7
Gaston,NC,108698,103677,5021,4.6
Gates,NC,5239,5002,237,4.5
Graham,NC,3172,2956,216,6.8
Granville,NC,30039,28877,1162,3.9
Greene,NC,9577,9145,432,4.5
Guilford,NC,260244,247698,12546,4.8
Halifax,NC,20659,19135,1524,7.4
Harnett,NC,52575,49870,2705,5.1
Haywood,NC,29020,27833,1187,4.1
Henderson,NC,53278,51222,2056,3.9
Hertford,NC,9275,8735,540,5.8
Hoke,NC,19912,18760,1152,5.8
Hyde,NC,2122,1941,181,8.5
Iredell,NC,87100,83394,3706,4.3
Jackson,NC,18983,18064,919,4.8
Johnston,NC,93991,90069,3922,4.2
Jones,NC,4497,4295,202,4.5
Lee,NC,26639,25267,1372,5.2
Lenoir,NC,28126,26844,1282,4.6
Lincoln,NC,42232,40529,1703,4
McDowell,NC,20948,20078,870,4.2
Macon,NC,15216,14498,718,4.7
Madison,NC,9873,9444,429,4.3
Martin,NC,9636,9081,555,5.8
Mecklenburg,NC,601998,576068,25930,4.3
Mitchell,NC,6114,5789,325,5.3
Montgomery,NC,11732,11188,544,4.6
Moore,NC,39922,38118,1804,4.5
Nash,NC,43584,40912,2672,6.1
New Hanover,NC,118501,113526,4975,4.2
Northampton,NC,7769,7276,493,6.3
Onslow,NC,64162,60903,3259,5.1
Orange,NC,76435,73514,2921,3.8
Pamlico,NC,5416,5156,260,4.8
Pasquotank,NC,17493,16517,976,5.6
Pender,NC,27362,26069,1293,4.7
Perquimans,NC,5117,4821,296,5.8
Person,NC,18321,17466,855,4.7
Pitt,NC,89270,84865,4405,4.9
Polk,NC,8944,8567,377,4.2
Randolph,NC,67249,64275,2974,4.4
Richmond,NC,16726,15700,1026,6.1
Robeson,NC,50296,46953,3343,6.6
Rockingham,NC,41106,38956,2150,5.2
Rowan,NC,65907,62804,3103,4.7
Rutherford,NC,24610,23096,1514,6.2
Sampson,NC,29398,27984,1414,4.8
Scotland,NC,11523,10619,904,7.8
Stanly,NC,29824,28585,1239,4.2
Stokes,NC,22034,21087,947,4.3
Surry,NC,33680,32246,1434,4.3
Swain,NC,6941,6587,354,5.1
Transylvania,NC,14217,13597,620,4.4
Tyrrell,NC,1534,1417,117,7.6
Union,NC,119334,114557,4777,4
Vance,NC,17897,16775,1122,6.3
Wake,NC,572771,550321,22450,3.9
Warren,NC,6872,6395,477,6.9
Washington,NC,4805,4480,325,6.8
Watauga,NC,28574,27401,1173,4.1
Wayne,NC,53488,50752,2736,5.1
Wilkes,NC,31187,29845,1342,4.3
Wilson,NC,36056,33419,2637,7.3
Yadkin,NC,17756,17043,713,4
Yancey,NC,7452,7109,343,4.6
Adams,ND,1122,1095,27,2.4
Barnes,ND,5519,5368,151,2.7
Benson,ND,2400,2315,85,3.5
Billings,ND,437,424,13,3
Bottineau,ND,3147,3044,103,3.3
Bowman,ND,1793,1762,31,1.7
Burke,ND,1104,1070,34,3.1
Burleigh,ND,50739,49515,1224,2.4
Cass,ND,102364,100234,2130,2.1
Cavalier,ND,2101,2046,55,2.6
Dickey,ND,2552,2507,45,1.8
Divide,ND,1623,1596,27,1.7
Dunn,ND,3211,3143,68,2.1
Eddy,ND,1301,1241,60,4.6
Emmons,ND,1580,1517,63,4
Foster,ND,1675,1634,41,2.4
Golden Valley,ND,955,936,19,2
Grand Forks,ND,39203,38347,856,2.2
Grant,ND,1289,1252,37,2.9
Griggs,ND,1137,1104,33,2.9
Hettinger,ND,1528,1499,29,1.9
Kidder,ND,1355,1307,48,3.5
LaMoure,ND,2298,2255,43,1.9
Logan,ND,958,934,24,2.5
McHenry,ND,3339,3199,140,4.2
McIntosh,ND,1249,1217,32,2.6
McKenzie,ND,8198,7997,201,2.5
McLean,ND,5103,4945,158,3.1
Mercer,ND,4520,4341,179,4
Morton,ND,16805,16294,511,3
Mountrail,ND,7088,6945,143,2
Nelson,ND,1503,1457,46,3.1
Oliver,ND,887,850,37,4.2
Pembina,ND,3575,3428,147,4.1
Pierce,ND,1922,1861,61,3.2
Ramsey,ND,5872,5715,157,2.7
Ransom,ND,2852,2797,55,1.9
Renville,ND,1305,1272,33,2.5
Richland,ND,8882,8673,209,2.4
Rolette,ND,4883,4387,496,10.2
Sargent,ND,2399,2350,49,2
Sheridan,ND,728,695,33,4.5
Sioux,ND,1333,1285,48,3.6
Slope,ND,427,419,8,1.9
Stark,ND,18283,17794,489,2.7
Steele,ND,1082,1064,18,1.7
Stutsman,ND,11074,10817,257,2.3
Towner,ND,1237,1206,31,2.5
Traill,ND,4654,4542,112,2.4
Walsh,ND,5647,5461,186,3.3
Ward,ND,32971,31909,1062,3.2
Wells,ND,2183,2113,70,3.2
Williams,ND,23013,22436,577,2.5
Adams,OH,10996,10208,788,7.2
Allen,OH,48897,46453,2444,5
Ashland,OH,26366,25073,1293,4.9
Ashtabula,OH,44321,41696,2625,5.9
Athens,OH,28594,26863,1731,6.1
Auglaize,OH,24734,23813,921,3.7
Belmont,OH,30705,28764,1941,6.3
Brown,OH,19726,18600,1126,5.7
Butler,OH,192374,183840,8534,4.4
Carroll,OH,13376,12592,784,5.9
Champaign,OH,19859,19032,827,4.2
Clark,OH,63813,60721,3092,4.8
Clermont,OH,105450,100835,4615,4.4
Clinton,OH,17593,16636,957,5.4
Columbiana,OH,48018,45151,2867,6
Coshocton,OH,14775,13768,1007,6.8
Crawford,OH,19020,17927,1093,5.7
Cuyahoga,OH,610874,575119,35755,5.9
Darke,OH,26452,25340,1112,4.2
Defiance,OH,18498,17596,902,4.9
Delaware,OH,106926,103168,3758,3.5
Erie,OH,37920,35571,2349,6.2
Fairfield,OH,77449,74149,3300,4.3
Fayette,OH,14479,13866,613,4.2
Franklin,OH,680584,653209,27375,4
Fulton,OH,22640,21533,1107,4.9
Gallia,OH,12174,11356,818,6.7
Geauga,OH,48802,46476,2326,4.8
Greene,OH,82142,78636,3506,4.3
Guernsey,OH,18907,17758,1149,6.1
Hamilton,OH,411260,393259,18001,4.4
Hancock,OH,41822,40307,1515,3.6
Hardin,OH,14371,13658,713,5
Harrison,OH,7116,6689,427,6
Henry,OH,13655,12946,709,5.2
Highland,OH,17154,16126,1028,6
Hocking,OH,13251,12538,713,5.4
Holmes,OH,20813,20074,739,3.6
Huron,OH,28075,26259,1816,6.5
Jackson,OH,12956,12030,926,7.1
Jefferson,OH,28373,26313,2060,7.3
Knox,OH,31269,29860,1409,4.5
Lake,OH,124193,117784,6409,5.2
Lawrence,OH,24732,23288,1444,5.8
Licking,OH,89801,86043,3758,4.2
Logan,OH,23540,22571,969,4.1
Lorain,OH,151638,142277,9361,6.2
Lucas,OH,211724,199256,12468,5.9
Madison,OH,20674,19880,794,3.8
Mahoning,OH,105154,97890,7264,6.9
Marion,OH,28031,26604,1427,5.1
Medina,OH,95615,91089,4526,4.7
Meigs,OH,8970,8239,731,8.1
Mercer,OH,23707,22978,729,3.1
Miami,OH,53691,51411,2280,4.2
Monroe,OH,5152,4713,439,8.5
Montgomery,OH,253576,241211,12365,4.9
Morgan,OH,6675,6218,457,6.8
Morrow,OH,17053,16222,831,4.9
Muskingum,OH,39699,37426,2273,5.7
Noble,OH,4806,4460,346,7.2
Ottawa,OH,21350,19922,1428,6.7
Paulding,OH,8862,8468,394,4.4
Perry,OH,16137,15171,966,6
Pickaway,OH,26635,25412,1223,4.6
Pike,OH,10880,10124,756,6.9
Portage,OH,87688,83267,4421,5
Preble,OH,21150,20199,951,4.5
Putnam,OH,19006,18329,677,3.6
Richland,OH,53228,50297,2931,5.5
Ross,OH,34130,32377,1753,5.1
Sandusky,OH,31354,29866,1488,4.7
Scioto,OH,29715,27606,2109,7.1
Seneca,OH,27323,26020,1303,4.8
Shelby,OH,24143,23148,995,4.1
Stark,OH,187574,177765,9809,5.2
Summit,OH,274131,260247,13884,5.1
Trumbull,OH,89686,83207,6479,7.2
Tuscarawas,OH,45706,43416,2290,5
Union,OH,28240,27189,1051,3.7
Van Wert,OH,14436,13862,574,4
Vinton,OH,5464,5091,373,6.8
Warren,OH,116363,111581,4782,4.1
Washington,OH,27626,25910,1716,6.2
Wayne,OH,61709,59274,2435,3.9
Williams,OH,19061,18222,839,4.4
Wood,OH,70693,67581,3112,4.4
Wyandot,OH,12732,12260,472,3.7
Adair,OK,8272,7857,415,5
Alfalfa,OK,2947,2868,79,2.7
Atoka,OK,5211,4934,277,5.3
Beaver,OK,3046,2967,79,2.6
Beckham,OK,11364,10915,449,4
Blaine,OK,4585,4453,132,2.9
Bryan,OK,20496,19712,784,3.8
Caddo,OK,12367,11812,555,4.5
Canadian,OK,69836,67347,2489,3.6
Carter,OK,22511,21476,1035,4.6
Cherokee,OK,19082,18040,1042,5.5
Choctaw,OK,5731,5375,356,6.2
Cimarron,OK,1414,1380,34,2.4
Cleveland,OK,140218,135278,4940,3.5
Coal,OK,2292,2168,124,5.4
Comanche,OK,49246,47061,2185,4.4
Cotton,OK,2858,2743,115,4
Craig,OK,6082,5810,272,4.5
Creek,OK,31523,29941,1582,5
Custer,OK,15362,14852,510,3.3
Delaware,OK,18488,17674,814,4.4
Dewey,OK,2490,2416,74,3
Ellis,OK,2236,2163,73,3.3
Garfield,OK,27936,26838,1098,3.9
Garvin,OK,12630,12101,529,4.2
Grady,OK,26098,25035,1063,4.1
Grant,OK,2909,2833,76,2.6
Greer,OK,2081,1970,111,5.3
Harmon,OK,1288,1239,49,3.8
Harper,OK,1849,1791,58,3.1
Haskell,OK,4372,4082,290,6.6
Hughes,OK,5435,5128,307,5.6
Jackson,OK,10898,10480,418,3.8
Jefferson,OK,2506,2366,140,5.6
Johnston,OK,4986,4784,202,4.1
Kay,OK,19236,18177,1059,5.5
Kingfisher,OK,8662,8420,242,2.8
Kiowa,OK,3948,3736,212,5.4
Latimer,OK,3419,3162,257,7.5
Le Flore,OK,19373,18247,1126,5.8
Lincoln,OK,15870,15176,694,4.4
Logan,OK,21719,20913,806,3.7
Love,OK,6607,6410,197,3
McClain,OK,19030,18348,682,3.6
McCurtain,OK,14830,13892,938,6.3
McIntosh,OK,6934,6392,542,7.8
Major,OK,4011,3882,129,3.2
Marshall,OK,6548,6240,308,4.7
Mayes,OK,19145,18225,920,4.8
Murray,OK,6428,6188,240,3.7
Muskogee,OK,29534,28007,1527,5.2
Noble,OK,5784,5592,192,3.3
Nowata,OK,4618,4365,253,5.5
Okfuskee,OK,4473,4201,272,6.1
Oklahoma,OK,378076,362857,15219,4
Okmulgee,OK,16147,15131,1016,6.3
Osage,OK,21127,20043,1084,5.1
Ottawa,OK,14461,13819,642,4.4
Pawnee,OK,7453,7053,400,5.4
Payne,OK,38565,37164,1401,3.6
Pittsburg,OK,17645,16699,946,5.4
Pontotoc,OK,18730,18019,711,3.8
Pottawatomie,OK,33062,31685,1377,4.2
Pushmataha,OK,4774,4479,295,6.2
Roger Mills,OK,1872,1811,61,3.3
Rogers,OK,45043,43053,1990,4.4
Seminole,OK,9338,8791,547,5.9
Sequoyah,OK,16575,15662,913,5.5
Stephens,OK,18256,17115,1141,6.3
Texas,OK,9385,9090,295,3.1
Tillman,OK,3263,3123,140,4.3
Tulsa,OK,319989,306261,13728,4.3
Wagoner,OK,36823,35200,1623,4.4
Washington,OK,23143,22079,1064,4.6
Washita,OK,5437,5195,242,4.5
Woods,OK,4928,4797,131,2.7
Woodward,OK,9414,9018,396,4.2
Baker,OR,7070,6684,386,5.5
Benton,OR,48126,46556,1570,3.3
Clackamas,OR,218947,210756,8191,3.7
Clatsop,OR,19248,18453,795,4.1
Columbia,OR,24224,22971,1253,5.2
Coos,OR,26645,25174,1471,5.5
Crook,OR,9563,8964,599,6.3
Curry,OR,9049,8498,551,6.1
Deschutes,OR,93470,89533,3937,4.2
Douglas,OR,46572,44080,2492,5.4
Gilliam,OR,865,829,36,4.2
Grant,OR,3162,2946,216,6.8
Harney,OR,3438,3223,215,6.3
Hood River,OR,14359,13841,518,3.6
Jackson,OR,103952,98993,4959,4.8
Jefferson,OR,10041,9481,560,5.6
Josephine,OR,35392,33487,1905,5.4
Klamath,OR,29880,28120,1760,5.9
Lake,OR,3545,3343,202,5.7
Lane,OR,182399,174281,8118,4.5
Lincoln,OR,21197,20191,1006,4.7
Linn,OR,57998,55235,2763,4.8
Malheur,OR,12618,12028,590,4.7
Marion,OR,162450,155459,6991,4.3
Morrow,OR,5856,5597,259,4.4
Multnomah,OR,457151,440545,16606,3.6
Polk,OR,39548,37832,1716,4.3
Sherman,OR,897,854,43,4.8
Tillamook,OR,11786,11285,501,4.3
Umatilla,OR,36924,35139,1785,4.8
Union,OR,12068,11430,638,5.3
Wallowa,OR,3359,3172,187,5.6
Wasco,OR,13955,13378,577,4.1
Washington,OR,323022,311718,11304,3.5
Wheeler,OR,743,714,29,3.9
Yamhill,OR,54567,52507,2060,3.8
Adams,PA,55457,53419,2038,3.7
Allegheny,PA,645906,615193,30713,4.8
Armstrong,PA,32676,30667,2009,6.1
Beaver,PA,84912,80204,4708,5.5
Bedford,PA,23757,22527,1230,5.2
Berks,PA,212082,202309,9773,4.6
Blair,PA,60219,57300,2919,4.8
Bradford,PA,29363,27854,1509,5.1
Bucks,PA,341433,326960,14473,4.2
Butler,PA,98326,93801,4525,4.6
Cambria,PA,59765,56138,3627,6.1
Cameron,PA,2201,2049,152,6.9
Carbon,PA,31500,29747,1753,5.6
Centre,PA,78636,75729,2907,3.7
Chester,PA,281136,271053,10083,3.6
Clarion,PA,17723,16722,1001,5.6
Clearfield,PA,35854,33714,2140,6
Clinton,PA,18317,17182,1135,6.2
Columbia,PA,33804,32039,1765,5.2
Crawford,PA,39398,37231,2167,5.5
Cumberland,PA,129985,125031,4954,3.8
Dauphin,PA,141982,135578,6404,4.5
Delaware,PA,294762,281424,13338,4.5
Elk,PA,15996,15218,778,4.9
Erie,PA,130755,123192,7563,5.8
Fayette,PA,57811,53806,4005,6.9
Forest,PA,1832,1709,123,6.7
Franklin,PA,76656,73242,3414,4.5
Fulton,PA,7191,6821,370,5.1
Greene,PA,16835,15838,997,5.9
Huntingdon,PA,19739,18552,1187,6
Indiana,PA,39219,36896,2323,5.9
Jefferson,PA,20572,19418,1154,5.6
Juniata,PA,12394,11820,574,4.6
Lackawanna,PA,106305,100852,5453,5.1
Lancaster,PA,280293,269590,10703,3.8
Lawrence,PA,40603,38132,2471,6.1
Lebanon,PA,70550,67635,2915,4.1
Lehigh,PA,188781,179294,9487,5
Luzerne,PA,158265,148913,9352,5.9
Lycoming,PA,57623,54369,3254,5.6
McKean,PA,18148,17029,1119,6.2
Mercer,PA,50990,48200,2790,5.5
Mifflin,PA,20630,19527,1103,5.3
Monroe,PA,81955,77141,4814,5.9
Montgomery,PA,448710,431390,17320,3.9
Montour,PA,9096,8744,352,3.9
Northampton,PA,158727,150948,7779,4.9
Northumberland,PA,43683,41201,2482,5.7
Perry,PA,24239,23198,1041,4.3
Philadelphia,PA,704053,660073,43980,6.2
Pike,PA,24836,23365,1471,5.9
Potter,PA,7228,6754,474,6.6
Schuylkill,PA,66298,62412,3886,5.9
Snyder,PA,20541,19630,911,4.4
Somerset,PA,33582,31536,2046,6.1
Sullivan,PA,2783,2622,161,5.8
Susquehanna,PA,20651,19674,977,4.7
Tioga,PA,19220,18069,1151,6
Union,PA,19834,18966,868,4.4
Venango,PA,23056,21645,1411,6.1
Warren,PA,19337,18315,1022,5.3
Washington,PA,106484,100896,5588,5.2
Wayne,PA,22528,21384,1144,5.1
Westmoreland,PA,181839,172417,9422,5.2
Wyoming,PA,13958,13224,734,5.3
York,PA,234356,224108,10248,4.4
Bristol,RI,26179,25176,1003,3.8
Kent,RI,91029,87306,3723,4.1
Newport,RI,44318,42580,1738,3.9
Providence,RI,323988,308436,15552,4.8
Washington,RI,69144,66369,2775,4
Abbeville,SC,10103,9640,463,4.6
Aiken,SC,74442,71386,3056,4.1
Allendale,SC,2741,2553,188,6.9
Anderson,SC,89559,86045,3514,3.9
Bamberg,SC,5230,4842,388,7.4
Barnwell,SC,8082,7594,488,6
Beaufort,SC,74104,71113,2991,4
Berkeley,SC,98452,94691,3761,3.8
Calhoun,SC,6848,6493,355,5.2
Charleston,SC,204937,197802,7135,3.5
Cherokee,SC,24094,22909,1185,4.9
Chester,SC,13592,12776,816,6
Chesterfield,SC,21621,20680,941,4.4
Clarendon,SC,12425,11683,742,6
Colleton,SC,16844,16036,808,4.8
Darlington,SC,29830,28247,1583,5.3
Dillon,SC,12574,11857,717,5.7
Dorchester,SC,74263,71413,2850,3.8
Edgefield,SC,10557,10075,482,4.6
Fairfield,SC,10045,9305,740,7.4
Florence,SC,65368,62379,2989,4.6
Georgetown,SC,25289,23893,1396,5.5
Greenville,SC,247585,238524,9061,3.7
Greenwood,SC,30880,29482,1398,4.5
Hampton,SC,8210,7843,367,4.5
Horry,SC,143389,136283,7106,5
Jasper,SC,12228,11783,445,3.6
Kershaw,SC,29130,27810,1320,4.5
Lancaster,SC,39127,37308,1819,4.6
Laurens,SC,30194,28869,1325,4.4
Lee,SC,6414,6027,387,6
Lexington,SC,147870,142516,5354,3.6
McCormick,SC,3385,3230,155,4.6
Marion,SC,12541,11611,930,7.4
Marlboro,SC,9257,8650,607,6.6
Newberry,SC,18491,17720,771,4.2
Oconee,SC,34315,32817,1498,4.4
Orangeburg,SC,35174,32669,2505,7.1
Pickens,SC,56658,54320,2338,4.1
Richland,SC,199987,191462,8525,4.3
Saluda,SC,8854,8507,347,3.9
Spartanburg,SC,146296,140420,5876,4
Sumter,SC,44112,41794,2318,5.3
Union,SC,11759,11129,630,5.4
Williamsburg,SC,12389,11603,786,6.3
York,SC,133410,128109,5301,4
Aurora,SD,1516,1473,43,2.8
Beadle,SD,9350,9082,268,2.9
Bennett,SD,1121,1071,50,4.5
Bon Homme,SD,2918,2829,89,3.1
Brookings,SD,18815,18222,593,3.2
Brown,SD,20950,20319,631,3
Brule,SD,2455,2381,74,3
Buffalo,SD,716,662,54,7.5
Butte,SD,5019,4834,185,3.7
Campbell,SD,827,798,29,3.5
Charles Mix,SD,3867,3724,143,3.7
Clark,SD,1897,1809,88,4.6
Clay,SD,7145,6909,236,3.3
Codington,SD,15186,14676,510,3.4
Corson,SD,1419,1360,59,4.2
Custer,SD,4014,3841,173,4.3
Davison,SD,11108,10785,323,2.9
Day,SD,2835,2719,116,4.1
Deuel,SD,2194,2088,106,4.8
Dewey,SD,2234,2006,228,10.2
Douglas,SD,1621,1573,48,3
Edmunds,SD,2133,2073,60,2.8
Fall River,SD,2982,2858,124,4.2
Faulk,SD,1105,1070,35,3.2
Grant,SD,4477,4317,160,3.6
Gregory,SD,2025,1953,72,3.6
Haakon,SD,1086,1055,31,2.9
Hamlin,SD,3163,3047,116,3.7
Hand,SD,1823,1777,46,2.5
Hanson,SD,1742,1671,71,4.1
Harding,SD,731,707,24,3.3
Hughes,SD,10040,9760,280,2.8
Hutchinson,SD,3602,3489,113,3.1
Hyde,SD,691,669,22,3.2
Jackson,SD,1321,1244,77,5.8
Jerauld,SD,1118,1091,27,2.4
Jones,SD,562,545,17,3
Kingsbury,SD,2729,2642,87,3.2
Lake,SD,6472,6219,253,3.9
Lawrence,SD,12997,12565,432,3.3
Lincoln,SD,31959,31164,795,2.5
Lyman,SD,1746,1659,87,5
McCook,SD,3151,3063,88,2.8
McPherson,SD,1044,1007,37,3.5
Marshall,SD,2386,2276,110,4.6
Meade,SD,13898,13418,480,3.5
Mellette,SD,758,720,38,5
Miner,SD,1197,1161,36,3
Minnehaha,SD,109516,106400,3116,2.8
Moody,SD,3983,3834,149,3.7
Oglala Lakota,SD,3586,3163,423,11.8
Pennington,SD,55730,53838,1892,3.4
Perkins,SD,1618,1570,48,3
Potter,SD,1139,1100,39,3.4
Roberts,SD,4812,4579,233,4.8
Sanborn,SD,1164,1123,41,3.5
Spink,SD,3227,3115,112,3.5
Stanley,SD,1863,1801,62,3.3
Sully,SD,845,818,27,3.2
Todd,SD,3168,2958,210,6.6
Tripp,SD,3016,2929,87,2.9
Turner,SD,4706,4554,152,3.2
Union,SD,7926,7634,292,3.7
Walworth,SD,2237,2122,115,5.1
Yankton,SD,11541,11200,341,3
Ziebach,SD,960,910,50,5.2
Anderson,TN,34175,32842,1333,3.9
Bedford,TN,20539,19735,804,3.9
Benton,TN,6769,6405,364,5.4
Bledsoe,TN,4317,4064,253,5.9
Blount,TN,61819,59667,2152,3.5
Bradley,TN,50172,48336,1836,3.7
Campbell,TN,14825,14066,759,5.1
Cannon,TN,6235,6014,221,3.5
Carroll,TN,12000,11381,619,5.2
Carter,TN,23911,22825,1086,4.5
Cheatham,TN,21003,20367,636,3
Chester,TN,8526,8188,338,4
Claiborne,TN,12734,12132,602,4.7
Clay,TN,3084,2928,156,5.1
Cocke,TN,14619,13857,762,5.2
Coffee,TN,25035,24122,913,3.6
Crockett,TN,6959,6671,288,4.1
Cumberland,TN,23574,22490,1084,4.6
Davidson,TN,388112,377454,10658,2.7
Decatur,TN,4656,4414,242,5.2
DeKalb,TN,7732,7370,362,4.7
Dickson,TN,25674,24827,847,3.3
Dyer,TN,16132,15352,780,4.8
Fayette,TN,18522,17785,737,4
Fentress,TN,7132,6812,320,4.5
Franklin,TN,19907,19154,753,3.8
Gibson,TN,21386,20410,976,4.6
Giles,TN,15600,15068,532,3.4
Grainger,TN,9409,9014,395,4.2
Greene,TN,30828,29445,1383,4.5
Grundy,TN,4851,4609,242,5
Hamblen,TN,27312,26215,1097,4
Hamilton,TN,176554,170150,6404,3.6
Hancock,TN,2051,1932,119,5.8
Hardeman,TN,9263,8785,478,5.2
Hardin,TN,10422,9931,491,4.7
Hawkins,TN,23838,22838,1000,4.2
Haywood,TN,7865,7458,407,5.2
Henderson,TN,11904,11293,611,5.1
Henry,TN,14035,13400,635,4.5
Hickman,TN,10789,10422,367,3.4
Houston,TN,3205,3021,184,5.7
Humphreys,TN,8840,8462,378,4.3
Jackson,TN,4586,4342,244,5.3
Jefferson,TN,23978,23015,963,4
Johnson,TN,7625,7325,300,3.9
Knox,TN,237543,230043,7500,3.2
Lake,TN,1859,1754,105,5.6
Lauderdale,TN,9455,8896,559,5.9
Lawrence,TN,17769,16994,775,4.4
Lewis,TN,4945,4721,224,4.5
Lincoln,TN,16316,15781,535,3.3
Loudon,TN,22622,21799,823,3.6
McMinn,TN,22821,21829,992,4.3
McNairy,TN,8591,8109,482,5.6
Macon,TN,10625,10262,363,3.4
Madison,TN,48256,46362,1894,3.9
Marion,TN,12176,11591,585,4.8
Marshall,TN,15535,15018,517,3.3
Maury,TN,45784,44312,1472,3.2
Meigs,TN,5007,4747,260,5.2
Monroe,TN,19734,18950,784,4
Montgomery,TN,80988,77686,3302,4.1
Moore,TN,3484,3376,108,3.1
Morgan,TN,7871,7489,382,4.9
Obion,TN,12273,11600,673,5.5
Overton,TN,9590,9195,395,4.1
Perry,TN,3242,3086,156,4.8
Pickett,TN,2454,2346,108,4.4
Polk,TN,7372,7036,336,4.6
Putnam,TN,34084,32807,1277,3.7
Rhea,TN,13275,12423,852,6.4
Roane,TN,23150,22140,1010,4.4
Robertson,TN,36117,34901,1216,3.4
Rutherford,TN,169956,165060,4896,2.9
Scott,TN,8171,7756,415,5.1
Sequatchie,TN,6087,5787,300,4.9
Sevier,TN,52301,50215,2086,4
Shelby,TN,439415,420439,18976,4.3
Smith,TN,8996,8678,318,3.5
Stewart,TN,5203,4926,277,5.3
Sullivan,TN,70193,67370,2823,4
Sumner,TN,95769,92939,2830,3
Tipton,TN,27774,26553,1221,4.4
Trousdale,TN,3971,3834,137,3.5
Unicoi,TN,7044,6667,377,5.4
Union,TN,7359,7038,321,4.4
Van Buren,TN,2099,2008,91,4.3
Warren,TN,17195,16521,674,3.9
Washington,TN,59402,57152,2250,3.8
Wayne,TN,6157,5838,319,5.2
Weakley,TN,15897,15125,772,4.9
White,TN,11965,11492,473,4
Williamson,TN,118004,114854,3150,2.7
Wilson,TN,70373,68315,2058,2.9
Anderson,TX,23262,22419,843,3.6
Andrews,TX,9011,8735,276,3.1
Angelina,TX,36614,34757,1857,5.1
Aransas,TX,10366,9665,701,6.8
Archer,TX,4093,3953,140,3.4
Armstrong,TX,920,897,23,2.5
Atascosa,TX,21181,20295,886,4.2
Austin,TX,13997,13391,606,4.3
Bailey,TX,2670,2556,114,4.3
Bandera,TX,9639,9293,346,3.6
Bastrop,TX,40124,38709,1415,3.5
Baylor,TX,1599,1544,55,3.4
Bee,TX,9938,9297,641,6.4
Bell,TX,141233,135305,5928,4.2
Bexar,TX,924590,892277,32313,3.5
Blanco,TX,6217,6048,169,2.7
Borden,TX,318,307,11,3.5
Bosque,TX,8176,7850,326,4
Bowie,TX,39326,37537,1789,4.5
Brazoria,TX,171954,162901,9053,5.3
Brazos,TX,113424,109948,3476,3.1
Brewster,TX,3921,3784,137,3.5
Briscoe,TX,556,532,24,4.3
Brooks,TX,2425,2226,199,8.2
Brown,TX,16183,15562,621,3.8
Burleson,TX,7987,7658,329,4.1
Burnet,TX,22153,21451,702,3.2
Caldwell,TX,18406,17694,712,3.9
Calhoun,TX,10424,9818,606,5.8
Callahan,TX,5843,5628,215,3.7
Cameron,TX,166268,154837,11431,6.9
Camp,TX,5040,4756,284,5.6
Carson,TX,3060,2963,97,3.2
Cass,TX,12198,11472,726,6
Castro,TX,3358,3248,110,3.3
Chambers,TX,18511,17306,1205,6.5
Cherokee,TX,20659,19723,936,4.5
Childress,TX,2910,2824,86,3
Clay,TX,4797,4626,171,3.6
Cochran,TX,1133,1081,52,4.6
Coke,TX,1396,1345,51,3.7
Coleman,TX,3070,2934,136,4.4
Collin,TX,527317,509347,17970,3.4
Collingsworth,TX,1159,1117,42,3.6
Colorado,TX,10080,9693,387,3.8
Comal,TX,66826,64580,2246,3.4
Comanche,TX,5288,5093,195,3.7
Concho,TX,1207,1156,51,4.2
Cooke,TX,18826,18155,671,3.6
Coryell,TX,24691,23634,1057,4.3
Cottle,TX,517,495,22,4.3
Crane,TX,1588,1504,84,5.3
Crockett,TX,1689,1620,69,4.1
Crosby,TX,2603,2495,108,4.1
Culberson,TX,913,880,33,3.6
Dallam,TX,4056,3970,86,2.1
Dallas,TX,1333933,1282785,51148,3.8
Dawson,TX,4656,4429,227,4.9
Deaf Smith,TX,8339,8084,255,3.1
Delta,TX,2609,2524,85,3.3
Denton,TX,464581,449263,15318,3.3
DeWitt,TX,9586,9160,426,4.4
Dickens,TX,682,650,32,4.7
Dimmit,TX,6480,6150,330,5.1
Donley,TX,1507,1452,55,3.6
Duval,TX,4803,4435,368,7.7
Eastland,TX,7852,7513,339,4.3
Ector,TX,78116,74904,3212,4.1
Edwards,TX,904,875,29,3.2
Ellis,TX,87132,84141,2991,3.4
El Paso,TX,353387,337112,16275,4.6
Erath,TX,20586,19883,703,3.4
Falls,TX,6669,6389,280,4.2
Fannin,TX,15937,15407,530,3.3
Fayette,TX,12623,12224,399,3.2
Fisher,TX,1722,1661,61,3.5
Floyd,TX,2694,2546,148,5.5
Foard,TX,595,575,20,3.4
Fort Bend,TX,369788,352659,17129,4.6
Franklin,TX,4533,4325,208,4.6
Freestone,TX,6738,6313,425,6.3
Frio,TX,9300,8942,358,3.8
Gaines,TX,9239,8959,280,3
Galveston,TX,161703,153291,8412,5.2
Garza,TX,2117,2047,70,3.3
Gillespie,TX,13193,12853,340,2.6
Glasscock,TX,689,671,18,2.6
Goliad,TX,3244,3084,160,4.9
Gonzales,TX,9361,9035,326,3.5
Gray,TX,8216,7782,434,5.3
Grayson,TX,62020,59857,2163,3.5
Gregg,TX,57632,54678,2954,5.1
Grimes,TX,10842,10270,572,5.3
Guadalupe,TX,77510,74946,2564,3.3
Hale,TX,12418,11781,637,5.1
Hall,TX,1129,1059,70,6.2
Hamilton,TX,3607,3465,142,3.9
Hansford,TX,2856,2784,72,2.5
Hardeman,TX,1654,1590,64,3.9
Hardin,TX,25045,23511,1534,6.1
Harris,TX,2268944,2155485,113459,5
Harrison,TX,29410,27880,1530,5.2
Hartley,TX,2947,2889,58,2
Haskell,TX,2432,2317,115,4.7
Hays,TX,108012,104634,3378,3.1
Hemphill,TX,2335,2277,58,2.5
Henderson,TX,35566,34090,1476,4.2
Hidalgo,TX,341602,316347,25255,7.4
Hill,TX,16142,15516,626,3.9
Hockley,TX,11270,10851,419,3.7
Hood,TX,25691,24616,1075,4.2
Hopkins,TX,17145,16533,612,3.6
Houston,TX,10556,10109,447,4.2
Howard,TX,13197,12629,568,4.3
Hudspeth,TX,1537,1445,92,6
Hunt,TX,41487,39860,1627,3.9
Hutchinson,TX,9392,8827,565,6
Irion,TX,774,751,23,3
Jack,TX,3930,3783,147,3.7
Jackson,TX,7366,7072,294,4
Jasper,TX,13380,12384,996,7.4
Jeff Davis,TX,1052,1019,33,3.1
Jefferson,TX,107321,99467,7854,7.3
Jim Hogg,TX,1894,1757,137,7.2
Jim Wells,TX,16709,15450,1259,7.5
Johnson,TX,77413,74498,2915,3.8
Jones,TX,5635,5335,300,5.3
Karnes,TX,6424,6200,224,3.5
Kaufman,TX,59437,57346,2091,3.5
Kendall,TX,20705,20070,635,3.1
Kenedy,TX,246,238,8,3.3
Kent,TX,460,448,12,2.6
Kerr,TX,21290,20564,726,3.4
Kimble,TX,1897,1830,67,3.5
King,TX,163,157,6,3.7
Kinney,TX,1150,1087,63,5.5
Kleberg,TX,13367,12572,795,5.9
Knox,TX,1493,1434,59,4
Lamar,TX,23680,22685,995,4.2
Lamb,TX,5194,4926,268,5.2
Lampasas,TX,9235,8896,339,3.7
La Salle,TX,4203,4048,155,3.7
Lavaca,TX,8712,8400,312,3.6
Lee,TX,9625,9311,314,3.3
Leon,TX,6160,5770,390,6.3
Liberty,TX,31713,29466,2247,7.1
Limestone,TX,8315,7855,460,5.5
Lipscomb,TX,1633,1580,53,3.2
Live Oak,TX,5376,5126,250,4.7
Llano,TX,8319,8009,310,3.7
Loving,TX,100,95,5,5
Lubbock,TX,155834,150896,4938,3.2
Lynn,TX,2720,2618,102,3.8
McCulloch,TX,3703,3570,133,3.6
McLennan,TX,118021,113478,4543,3.8
McMullen,TX,740,726,14,1.9
Madison,TX,4669,4452,217,4.6
Marion,TX,4350,4104,246,5.7
Martin,TX,2568,2486,82,3.2
Mason,TX,1799,1739,60,3.3
Matagorda,TX,16930,15703,1227,7.2
Maverick,TX,23860,21651,2209,9.3
Medina,TX,21273,20459,814,3.8
Menard,TX,807,768,39,4.8
Midland,TX,89359,86673,2686,3
Milam,TX,10057,9551,506,5
Mills,TX,1917,1850,67,3.5
Mitchell,TX,2531,2392,139,5.5
Montague,TX,9083,8718,365,4
Montgomery,TX,267342,255765,11577,4.3
Moore,TX,11012,10693,319,2.9
Morris,TX,4653,4251,402,8.6
Motley,TX,490,472,18,3.7
Nacogdoches,TX,28538,27325,1213,4.3
Navarro,TX,22752,21857,895,3.9
Newton,TX,5312,4894,418,7.9
Nolan,TX,6778,6503,275,4.1
Nueces,TX,167523,158495,9028,5.4
Ochiltree,TX,4504,4338,166,3.7
Oldham,TX,890,868,22,2.5
Orange,TX,37246,34692,2554,6.9
Palo Pinto,TX,13403,12859,544,4.1
Panola,TX,10320,9756,564,5.5
Parker,TX,62302,60152,2150,3.5
Parmer,TX,4913,4791,122,2.5
Pecos,TX,6515,6221,294,4.5
Polk,TX,17435,16386,1049,6
Potter,TX,55923,54137,1786,3.2
Presidio,TX,3024,2741,283,9.4
Rains,TX,5666,5466,200,3.5
Randall,TX,70283,68303,1980,2.8
Reagan,TX,1772,1704,68,3.8
Real,TX,1049,989,60,5.7
Red River,TX,5215,4945,270,5.2
Reeves,TX,6917,6672,245,3.5
Refugio,TX,3112,2932,180,5.8
Roberts,TX,437,421,16,3.7
Robertson,TX,7351,7007,344,4.7
Rockwall,TX,48621,47011,1610,3.3
Runnels,TX,4563,4391,172,3.8
Rusk,TX,22113,20995,1118,5.1
Sabine,TX,3538,3235,303,8.6
San Augustine,TX,2872,2658,214,7.5
San Jacinto,TX,11436,10792,644,5.6
San Patricio,TX,30647,28314,2333,7.6
San Saba,TX,2411,2334,77,3.2
Schleicher,TX,1338,1289,49,3.7
Scurry,TX,6982,6677,305,4.4
Shackelford,TX,1875,1819,56,3
Shelby,TX,10781,10229,552,5.1
Sherman,TX,1289,1249,40,3.1
Smith,TX,105896,101599,4297,4.1
Somervell,TX,4218,4028,190,4.5
Starr,TX,26049,23009,3040,11.7
Stephens,TX,4030,3841,189,4.7
Sterling,TX,607,584,23,3.8
Stonewall,TX,621,600,21,3.4
Sutton,TX,1514,1437,77,5.1
Swisher,TX,2687,2578,109,4.1
Tarrant,TX,1033317,995339,37978,3.7
Taylor,TX,64051,61784,2267,3.5
Terrell,TX,391,372,19,4.9
Terry,TX,5245,4983,262,5
Throckmorton,TX,692,662,30,4.3
Titus,TX,12954,12262,692,5.3
Tom Green,TX,54003,52016,1987,3.7
Travis,TX,698755,677830,20925,3
Trinity,TX,5366,5070,296,5.5
Tyler,TX,7058,6542,516,7.3
Upshur,TX,17613,16689,924,5.2
Upton,TX,1543,1484,59,3.8
Uvalde,TX,11714,11168,546,4.7
Val Verde,TX,20007,18991,1016,5.1
Van Zandt,TX,25311,24368,943,3.7
Victoria,TX,42923,40853,2070,4.8
Walker,TX,23625,22536,1089,4.6
Waller,TX,22201,21120,1081,4.9
Ward,TX,5546,5321,225,4.1
Washington,TX,14856,14229,627,4.2
Webb,TX,114696,109922,4774,4.2
Wharton,TX,21054,20114,940,4.5
Wheeler,TX,2357,2261,96,4.1
Wichita,TX,55970,53903,2067,3.7
Wilbarger,TX,4950,4718,232,4.7
Willacy,TX,6303,5609,694,11
Williamson,TX,287330,278071,9259,3.2
Wilson,TX,24155,23320,835,3.5
Winkler,TX,3235,3066,169,5.2
Wise,TX,29844,28659,1185,4
Wood,TX,17323,16512,811,4.7
Yoakum,TX,3818,3683,135,3.5
Young,TX,8082,7776,306,3.8
Zapata,TX,5445,5045,400,7.3
Zavala,TX,3719,3306,413,11.1
Beaver,UT,3093,2966,127,4.1
Box Elder,UT,25535,24699,836,3.3
Cache,UT,63040,61291,1749,2.8
Carbon,UT,8372,7946,426,5.1
Daggett,UT,443,421,22,5
Davis,UT,170335,165116,5219,3.1
Duchesne,UT,8104,7638,466,5.8
Emery,UT,4255,4035,220,5.2
Garfield,UT,2934,2714,220,7.5
Grand,UT,5971,5653,318,5.3
Iron,UT,22381,21450,931,4.2
Juab,UT,5466,5282,184,3.4
Kane,UT,3770,3641,129,3.4
Millard,UT,6508,6294,214,3.3
Morgan,UT,5328,5175,153,2.9
Piute,UT,490,466,24,4.9
Rich,UT,1155,1118,37,3.2
Salt Lake,UT,621759,602541,19218,3.1
San Juan,UT,5820,5399,421,7.2
Sanpete,UT,12064,11590,474,3.9
Sevier,UT,9907,9523,384,3.9
Summit,UT,24597,23839,758,3.1
Tooele,UT,31829,30675,1154,3.6
Uintah,UT,13936,13089,847,6.1
Utah,UT,292474,283950,8524,2.9
Wasatch,UT,14632,14156,476,3.3
Washington,UT,70817,68367,2450,3.5
Wayne,UT,1472,1363,109,7.4
Weber,UT,124363,119813,4550,3.7
Addison,VT,20842,20256,586,2.8
Bennington,VT,18438,17770,668,3.6
Caledonia,VT,14714,14170,544,3.7
Chittenden,VT,95645,93463,2182,2.3
Essex,VT,2680,2555,125,4.7
Franklin,VT,27427,26587,840,3.1
Grand Isle,VT,3993,3853,140,3.5
Lamoille,VT,14102,13543,559,4
Orange,VT,15934,15445,489,3.1
Orleans,VT,13720,13025,695,5.1
Rutland,VT,30931,29839,1092,3.5
Washington,VT,34124,33115,1009,3
Windham,VT,22954,22247,707,3.1
Windsor,VT,29258,28508,750,2.6
Accomack,VA,15948,15179,769,4.8
Albemarle,VA,55748,53905,1843,3.3
Alleghany,VA,6842,6509,333,4.9
Amelia,VA,6246,5996,250,4
Amherst,VA,15085,14455,630,4.2
Appomattox,VA,7022,6709,313,4.5
Arlington,VA,149627,145904,3723,2.5
Augusta,VA,36841,35575,1266,3.4
Bath,VA,2452,2371,81,3.3
Bedford,VA,38238,36740,1498,3.9
Bland,VA,2731,2610,121,4.4
Botetourt,VA,17325,16705,620,3.6
Brunswick,VA,6006,5676,330,5.5
Buchanan,VA,6703,6193,510,7.6
Buckingham,VA,6406,6060,346,5.4
Campbell,VA,26129,25031,1098,4.2
Caroline,VA,15099,14448,651,4.3
Carroll,VA,12997,12392,605,4.7
Charles,VA,3772,3591,181,4.8
Charlotte,VA,5250,5001,249,4.7
Chesterfield,VA,183860,177184,6676,3.6
Clarke,VA,7519,7261,258,3.4
Craig,VA,2336,2234,102,4.4
Culpeper,VA,23786,22926,860,3.6
Cumberland,VA,4634,4438,196,4.2
Dickenson,VA,4408,4085,323,7.3
Dinwiddie,VA,13588,12976,612,4.5
Essex,VA,5470,5196,274,5
Fairfax,VA,629698,610531,19167,3
Fauquier,VA,36391,35199,1192,3.3
Floyd,VA,8093,7794,299,3.7
Fluvanna,VA,13519,13106,413,3.1
Franklin,VA,26196,25157,1039,4
Frederick,VA,46296,44818,1478,3.2
Giles,VA,7903,7530,373,4.7
Gloucester,VA,19304,18655,649,3.4
Goochland,VA,10969,10586,383,3.5
Grayson,VA,7220,6909,311,4.3
Greene,VA,10170,9860,310,3
Greensville,VA,4280,4084,196,4.6
Halifax,VA,14881,14101,780,5.2
Hanover,VA,58121,56179,1942,3.3
Henrico,VA,182026,175365,6661,3.7
Henry,VA,22541,21420,1121,5
Highland,VA,1244,1201,43,3.5
Isle of Wight,VA,19105,18359,746,3.9
James,VA,35352,34080,1272,3.6
King and Queen,VA,3766,3630,136,3.6
King George,VA,12359,11869,490,4
King William,VA,8856,8548,308,3.5
Lancaster,VA,5153,4870,283,5.5
Lee,VA,8245,7788,457,5.5
Loudoun,VA,211626,205188,6438,3
Louisa,VA,19087,18420,667,3.5
Lunenburg,VA,5198,4971,227,4.4
Madison,VA,7290,7075,215,2.9
Mathews,VA,4093,3938,155,3.8
Mecklenburg,VA,12150,11512,638,5.3
Middlesex,VA,5194,5017,177,3.4
Montgomery,VA,49863,47952,1911,3.8
Nelson,VA,7354,7097,257,3.5
New Kent,VA,11857,11475,382,3.2
Northampton,VA,5403,5087,316,5.8
Northumberland,VA,5364,5072,292,5.4
Nottoway,VA,6985,6708,277,4
Orange,VA,16539,15903,636,3.8
Page,VA,11640,11023,617,5.3
Patrick,VA,7429,7094,335,4.5
Pittsylvania,VA,29542,28201,1341,4.5
Powhatan,VA,13858,13394,464,3.3
Prince Edward,VA,10306,9792,514,5
Prince George,VA,15149,14477,672,4.4
Prince William,VA,239833,231667,8166,3.4
Pulaski,VA,16260,15390,870,5.4
Rappahannock,VA,3745,3615,130,3.5
Richmond,VA,3893,3746,147,3.8
Roanoke,VA,49144,47449,1695,3.4
Rockbridge,VA,10588,10155,433,4.1
Rockingham,VA,40837,39501,1336,3.3
Russell,VA,11056,10447,609,5.5
Scott,VA,9393,9009,384,4.1
Shenandoah,VA,21027,20282,745,3.5
Smyth,VA,13117,12411,706,5.4
Southampton,VA,8845,8512,333,3.8
Spotsylvania,VA,66131,63665,2466,3.7
Stafford,VA,69689,67165,2524,3.6
Surry,VA,3708,3540,168,4.5
Sussex,VA,3917,3684,233,5.9
Tazewell,VA,15866,14927,939,5.9
Warren,VA,20033,19290,743,3.7
Washington,VA,26908,25804,1104,4.1
Westmoreland,VA,9004,8581,423,4.7
Wise,VA,12986,12106,880,6.8
Wythe,VA,13646,12935,711,5.2
York,VA,32591,31430,1161,3.6
Alexandria,VA,98590,95761,2829,2.9
Bristol,VA,7471,7130,341,4.6
Buena Vista,VA,3316,3171,145,4.4
Charlottesville,VA,25558,24767,791,3.1
Chesapeake,VA,119577,114953,4624,3.9
Colonial Heights,VA,8849,8488,361,4.1
Covington,VA,2379,2230,149,6.3
Danville,VA,19140,17989,1151,6
Emporia,VA,2278,2153,125,5.5
Fairfax,VA,13251,12864,387,2.9
Falls Church,VA,8160,7941,219,2.7
Franklin,VA,3484,3291,193,5.5
Fredericksburg,VA,13823,13222,601,4.3
Galax,VA,2879,2749,130,4.5
Hampton,VA,64727,61435,3292,5.1
Harrisonburg,VA,24559,23462,1097,4.5
Hopewell,VA,9931,9326,605,6.1
Lexington,VA,2265,2137,128,5.7
Lynchburg,VA,35820,34043,1777,5
Manassas,VA,22051,21302,749,3.4
Manassas Park,VA,8644,8354,290,3.4
Martinsville,VA,5235,4879,356,6.8
Newport News,VA,90074,85883,4191,4.7
Norfolk,VA,111699,106502,5197,4.7
Norton,VA,1628,1538,90,5.5
Petersburg,VA,13392,12414,978,7.3
Poquoson,VA,6247,6029,218,3.5
Portsmouth,VA,44552,42134,2418,5.4
Radford,VA,8285,7867,418,5
Richmond,VA,116588,111499,5089,4.4
Roanoke,VA,48976,46910,2066,4.2
Salem,VA,12907,12413,494,3.8
Staunton,VA,11848,11415,433,3.7
Suffolk,VA,43492,41684,1808,4.2
Virginia Beach,VA,232521,224148,8373,3.6
Waynesboro,VA,10272,9853,419,4.1
Williamsburg,VA,6820,6460,360,5.3
Winchester,VA,14570,14043,527,3.6
Adams,WA,8918,8404,514,5.8
Asotin,WA,10262,9833,429,4.2
Benton,WA,97430,92070,5360,5.5
Chelan,WA,44518,42349,2169,4.9
Clallam,WA,27927,26023,1904,6.8
Clark,WA,227382,215782,11600,5.1
Columbia,WA,1766,1667,99,5.6
Cowlitz,WA,46010,43224,2786,6.1
Douglas,WA,21012,19812,1200,5.7
Ferry,WA,2539,2259,280,11
Franklin,WA,40873,38294,2579,6.3
Garfield,WA,916,866,50,5.5
Grant,WA,45310,42475,2835,6.3
Grays Harbor,WA,27971,25993,1978,7.1
Island,WA,34259,32475,1784,5.2
Jefferson,WA,12021,11285,736,6.1
King,WA,1230208,1184708,45500,3.7
Kitsap,WA,121104,115166,5938,4.9
Kittitas,WA,22228,21048,1180,5.3
Klickitat,WA,10051,9465,586,5.8
Lewis,WA,33151,30948,2203,6.6
Lincoln,WA,4955,4710,245,4.9
Mason,WA,23843,22272,1571,6.6
Okanogan,WA,20930,19492,1438,6.9
Pacific,WA,8410,7818,592,7
Pend Oreille,WA,4734,4381,353,7.5
Pierce,WA,417219,394842,22377,5.4
San Juan,WA,8235,7911,324,3.9
Skagit,WA,59436,56167,3269,5.5
Skamania,WA,5218,4896,322,6.2
Snohomish,WA,421369,403989,17380,4.1
Spokane,WA,240421,227426,12995,5.4
Stevens,WA,18284,16956,1328,7.3
Thurston,WA,134847,128150,6697,5
Wahkiakum,WA,1307,1214,93,7.1
Walla Walla,WA,29304,27861,1443,4.9
Whatcom,WA,110074,104560,5514,5
Whitman,WA,23465,22426,1039,4.4
Yakima,WA,126814,118212,8602,6.8
Barbour,WV,6927,6526,401,5.8
Berkeley,WV,54471,52462,2009,3.7
Boone,WV,7692,7209,483,6.3
Braxton,WV,5366,4971,395,7.4
Brooke,WV,9850,9252,598,6.1
Cabell,WV,41479,39599,1880,4.5
Calhoun,WV,2478,2219,259,10.5
Clay,WV,3175,2903,272,8.6
Doddridge,WV,3894,3732,162,4.2
Fayette,WV,15757,14750,1007,6.4
Gilmer,WV,2435,2261,174,7.1
Grant,WV,5873,5543,330,5.6
Greenbrier,WV,15723,14963,760,4.8
Hampshire,WV,10144,9745,399,3.9
Hancock,WV,12687,11914,773,6.1
Hardy,WV,5828,5539,289,5
Harrison,WV,32872,31278,1594,4.8
Jackson,WV,11930,11247,683,5.7
Jefferson,WV,28661,27759,902,3.1
Kanawha,WV,84245,80029,4216,5
Lewis,WV,6508,6078,430,6.6
Lincoln,WV,7214,6723,491,6.8
Logan,WV,10757,9950,807,7.5
McDowell,WV,4997,4574,423,8.5
Marion,WV,25559,24226,1333,5.2
Marshall,WV,13841,13009,832,6
Mason,WV,9985,9316,669,6.7
Mercer,WV,21365,20119,1246,5.8
Mineral,WV,11914,11272,642,5.4
Mingo,WV,6755,6171,584,8.6
Monongalia,WV,52106,50172,1934,3.7
Monroe,WV,6029,5772,257,4.3
Morgan,WV,7715,7409,306,4
Nicholas,WV,9351,8690,661,7.1
Ohio,WV,20565,19582,983,4.8
Pendleton,WV,3672,3538,134,3.6
Pleasants,WV,2856,2657,199,7
Pocahontas,WV,3742,3519,223,6
Preston,WV,15074,14326,748,5
Putnam,WV,26006,24783,1223,4.7
Raleigh,WV,29526,27942,1584,5.4
Randolph,WV,12099,11448,651,5.4
Ritchie,WV,4419,4177,242,5.5
Roane,WV,5117,4680,437,8.5
Summers,WV,4537,4283,254,5.6
Taylor,WV,7839,7458,381,4.9
Tucker,WV,3396,3222,174,5.1
Tyler,WV,3442,3194,248,7.2
Upshur,WV,9521,8948,573,6
Wayne,WV,15556,14651,905,5.8
Webster,WV,3362,3154,208,6.2
Wetzel,WV,7057,6550,507,7.2
Wirt,WV,2196,2023,173,7.9
Wood,WV,36269,34292,1977,5.5
Wyoming,WV,6998,6508,490,7
Adams,WI,8316,7893,423,5.1
Ashland,WI,8021,7655,366,4.6
Barron,WI,24821,23946,875,3.5
Bayfield,WI,7546,7149,397,5.3
Brown,WI,143350,139127,4223,2.9
Buffalo,WI,6626,6378,248,3.7
Burnett,WI,7365,7006,359,4.9
Calumet,WI,28041,27263,778,2.8
Chippewa,WI,33697,32515,1182,3.5
Clark,WI,18013,17461,552,3.1
Columbia,WI,32023,31081,942,2.9
Crawford,WI,8000,7670,330,4.1
Dane,WI,322336,314607,7729,2.4
Dodge,WI,48607,47188,1419,2.9
Door,WI,15682,15077,605,3.9
Douglas,WI,23776,22712,1064,4.5
Dunn,WI,24598,23791,807,3.3
Eau Claire,WI,59489,57758,1731,2.9
Florence,WI,2309,2200,109,4.7
Fond du Lac,WI,57544,55915,1629,2.8
Forest,WI,4063,3857,206,5.1
Grant,WI,28404,27506,898,3.2
Green,WI,21571,20984,587,2.7
Green Lake,WI,9731,9364,367,3.8
Iowa,WI,13969,13559,410,2.9
Iron,WI,2626,2463,163,6.2
Jackson,WI,10479,10127,352,3.4
Jefferson,WI,45977,44516,1461,3.2
Juneau,WI,13664,13207,457,3.3
Kenosha,WI,89921,86426,3495,3.9
Kewaunee,WI,11280,10934,346,3.1
La Crosse,WI,68207,66216,1991,2.9
Lafayette,WI,10213,9956,257,2.5
Langlade,WI,9726,9314,412,4.2
Lincoln,WI,15598,15039,559,3.6
Manitowoc,WI,41988,40494,1494,3.6
Marathon,WI,74325,72132,2193,3
Marinette,WI,20044,19155,889,4.4
Marquette,WI,7644,7351,293,3.8
Menominee,WI,1588,1492,96,6
Milwaukee,WI,478333,458982,19351,4
Monroe,WI,23649,22951,698,3
Oconto,WI,20793,20058,735,3.5
Oneida,WI,18434,17719,715,3.9
Outagamie,WI,104727,101585,3142,3
Ozaukee,WI,49473,48106,1367,2.8
Pepin,WI,4260,4108,152,3.6
Pierce,WI,25207,24362,845,3.4
Polk,WI,25067,24122,945,3.8
Portage,WI,39814,38589,1225,3.1
Price,WI,6830,6573,257,3.8
Racine,WI,100142,96065,4077,4.1
Richland,WI,9408,9128,280,3
Rock,WI,85722,82531,3191,3.7
Rusk,WI,7038,6727,311,4.4
St. Croix,WI,50667,49100,1567,3.1
Sauk,WI,35768,34726,1042,2.9
Sawyer,WI,8048,7671,377,4.7
Shawano,WI,21624,20925,699,3.2
Sheboygan,WI,63073,61320,1753,2.8
Taylor,WI,11277,10888,389,3.4
Trempealeau,WI,16611,16102,509,3.1
Vernon,WI,16052,15560,492,3.1
Vilas,WI,10188,9744,444,4.4
Walworth,WI,58265,56356,1909,3.3
Washburn,WI,8009,7697,312,3.9
Washington,WI,77851,75684,2167,2.8
Waukesha,WI,226578,219998,6580,2.9
Waupaca,WI,26715,25859,856,3.2
Waushara,WI,11557,11103,454,3.9
Winnebago,WI,94244,91437,2807,3
Wood,WI,35313,33985,1328,3.8
Albany,WY,20471,19888,583,2.8
Big Horn,WY,5396,5173,223,4.1
Campbell,WY,23083,21945,1138,4.9
Carbon,WY,7957,7641,316,4
Converse,WY,7481,7151,330,4.4
Crook,WY,3679,3551,128,3.5
Fremont,WY,19407,18327,1080,5.6
Goshen,WY,6983,6786,197,2.8
Hot Springs,WY,2329,2239,90,3.9
Johnson,WY,4196,4022,174,4.1
Laramie,WY,48162,46383,1779,3.7
Lincoln,WY,8727,8402,325,3.7
Natrona,WY,39569,37467,2102,5.3
Niobrara,WY,1319,1283,36,2.7
Park,WY,15688,15024,664,4.2
Platte,WY,4783,4605,178,3.7
Sheridan,WY,15791,15164,627,4
Sublette,WY,4252,4066,186,4.4
Sweetwater,WY,21581,20599,982,4.6
Teton,WY,15467,15005,462,3
Uinta,WY,9138,8727,411,4.5
Washakie,WY,4115,3947,168,4.1
Weston,WY,3771,3621,150,4
Adjuntas,PR,4424,3754,670,15.1
Aguada,PR,11992,10444,1548,12.9
Aguadilla,PR,15140,12935,2205,14.6
Aguas Buenas,PR,6658,5818,840,12.6
Aibonito,PR,6599,5660,939,14.2
Anasco,PR,9014,7886,1128,12.5
Arecibo,PR,23760,20982,2778,11.7
Arroyo,PR,5029,4131,898,17.9
Barceloneta,PR,5834,5011,823,14.1
Barranquitas,PR,7375,6525,850,11.5
Bayamon,PR,65253,60339,4914,7.5
Cabo Rojo,PR,14013,12088,1925,13.7
Caguas,PR,47551,43226,4325,9.1
Camuy,PR,9480,8382,1098,11.6
Canovanas,PR,15949,14385,1564,9.8
Carolina,PR,61412,56719,4693,7.6
Catano,PR,7826,7114,712,9.1
Cayey,PR,16110,14461,1649,10.2
Ceiba,PR,3812,3297,515,13.5
Ciales,PR,3855,3231,624,16.2
Cidra,PR,15270,13974,1296,8.5
Coamo,PR,10611,8894,1717,16.2
Comerio,PR,4945,4368,577,11.7
Corozal,PR,9037,8016,1021,11.3
Culebra,PR,952,912,40,4.2
Dorado,PR,12772,11878,894,7
Fajardo,PR,11211,9722,1489,13.3
Florida,PR,3361,2874,487,14.5
Guanica,PR,4107,3359,748,18.2
Guayama,PR,11800,9941,1859,15.8
Guayanilla,PR,5151,4300,851,16.5
Guaynabo,PR,36869,34955,1914,5.2
Gurabo,PR,17316,16027,1289,7.4
Hatillo,PR,13139,11291,1848,14.1
Hormigueros,PR,5529,4815,714,12.9
Humacao,PR,17393,14984,2409,13.9
Isabela,PR,12717,11011,1706,13.4
Jayuya,PR,4393,3833,560,12.7
Juana Diaz,PR,15065,13108,1957,13
Juncos,PR,12202,10794,1408,11.5
Lajas,PR,5549,4472,1077,19.4
Lares,PR,7377,6019,1358,18.4
Las Marias,PR,2896,2316,580,20
Las Piedras,PR,11153,9815,1338,12
Loiza,PR,8471,7664,807,9.5
Luquillo,PR,6235,5424,811,13
Manati,PR,11548,10311,1237,10.7
Maricao,PR,2080,1669,411,19.8
Maunabo,PR,2958,2453,505,17.1
Mayaguez,PR,22662,19595,3067,13.5
Moca,PR,10835,9236,1599,14.8
Morovis,PR,8027,7013,1014,12.6
Naguabo,PR,7960,7065,895,11.2
Naranjito,PR,7148,6300,848,11.9
Orocovis,PR,5115,4377,738,14.4
Patillas,PR,4690,3772,918,19.6
Penuelas,PR,6074,5014,1060,17.5
Ponce,PR,46181,40801,5380,11.6
Quebradillas,PR,6108,5144,964,15.8
Rincon,PR,4704,3979,725,15.4
Rio Grande,PR,16933,15285,1648,9.7
Sabana Grande,PR,6456,5368,1088,16.9
Salinas,PR,7411,5995,1416,19.1
San German,PR,10144,8557,1587,15.6
San Juan,PR,133655,124470,9185,6.9
San Lorenzo,PR,11942,10405,1537,12.9
San Sebastian,PR,10733,8829,1904,17.7
Santa Isabel,PR,9937,8599,1338,13.5
Toa Alta,PR,26362,24304,2058,7.8
Toa Baja,PR,29402,27033,2369,8.1
Trujillo Alto,PR,26734,25158,1576,5.9
Utuado,PR,6860,5908,952,13.9
Vega Alta,PR,9774,8723,1051,10.8
Vega Baja,PR,13467,11795,1672,12.4
Vieques,PR,3228,2787,441,13.7
Villalba,PR,7631,6138,1493,19.6
Yabucoa,PR,9010,7533,1477,16.4
Yauco,PR,10276,8498,1778,17.3